AMAC	is.;
AMADƏ	sif.;
AMADƏLİK	is.;
AMAL	is.;
AMALQALAŞ	is.;
AMAN	nida.;
AMAN-AMAN	is.;
AMAN-ZAMAN	sif.;
AMANABƏND	zer.;
AMANATABƏND	zer.;
AMANI	zer.;
AMANSIZ	sif.;
AMANSIZCA	zer.;
AMANSIZCA(SINA)	zer.;
AMANSIZCASINA	zer.;
AMANSIZLIQ	is.;
AMARALAZ	is.;
AMARANT	is.;
AMAVAKALAR	is.;
AMAZON	is.;
AMAZONKA	is.;
AMAZONLAR	is.;
