CALA	f.;
CALAL	is.;
CALALLI	sif.;
CALALLILIQ	is.;
CALAMAQ	f.;
CALAN	is.;
CALANMAQ	f.;
CALAQ	is.;
CALAQALTI	is.;
CALAQLA	f.;
CALAQLAMA	is.;
CALAQLAMAQ	f.;
CALAQLAN	f.;
CALAQLANMAQ	f.;
CALAQLAT	f.;
CALAQLATMAQ	f.;
CALAQLI	sif.;
CALAQLIQ	is.;
CALAQSIZ	sif.;
CALAQVURMA	is.;
CALAQÇI	is.;
CALAQÇILIQ	is.;
CALAT	f.;
CALATDIR	f.;
CALATDIRMAQ	f.;
CALATMAQ	f.;
CALAŞ	f.;
CALAŞDIR	f.;
CALAŞDIRMAQ	f.;
CALAŞIQ	sif.;
CALAŞMAQ	f.;
CALĞA	f.;
CALĞALIQ	is.;
