DAD	is.;
DAD	is.;
DAD	nida.;
DAD-AMAN	is.;
DAD-BİDAD	is.;
DAD-DA	is.;
DAD-DAMAQ	is.;
DAD-DUZ	is.;
DAD-FƏRYAD	is.;
DAD-FƏĞAN	is.;
DAD-HARAY	is.;
DADA	is.;
DADAMA	is.;
DADAMAL	sif.;
DADAN	f.;
DADANAQ	sif.;
DADANDIR	f.;
DADANDIRIL	f.;
DADANDIRILMAQ	f.;
DADANDIRMAQ	f.;
DADANIQ	sif.;
DADANMAQ	f.;
DADANMIŞ	f.;
DADAİST	is.;
DADAİZM	is.;
DADAŞ	is.;
DADBİLMƏ	is.;
DADBİLMƏZLİK	is.;
DADDIR	f.;
DADDIRMAQ	f.;
DADGÜL	is.;
DADGÜLLÜK	is.;
DADGƏR	is.;
DADICI	is.;
DADIL	f.;
DADILMAQ	f.;
DADIMLIQ	is.;
DADIX	f.;
DADIXMAQ	f.;
DADIZ	f.;
DADIZDIR	f.;
DADIZDIRIL	f.;
DADIZDIRILMAQ	f.;
DADIZDIRMAQ	f.;
DADIZMAQ	f.;
DADIŞ	f.;
DADIŞMAQ	f.;
DADLAN	f.;
DADLANDIR	f.;
DADLANDIRIL	f.;
DADLANDIRMAQ	f.;
DADLANMAQ	f.;
DADLI	is.;sif.;
DADLI-DADLI	sif.;
DADLI-DUZLU	sif.;
DADLI-LƏZZƏTLİ	sif.;
DADLI-TAMLI	sif.;
DADLICA	sif.;
DADLILIQ	is.;
DADMALI	f.;
DADMAQ	f.;
DADRƏS	is.;
DADSIZ	sif.;
DADSIZ-DUZSUZ	sif.;
DADSIZLIQ	is.;
DADVERİCİ	sif.;
DADXAH	is.;
DADÜ-BİDAD	is.;
DADÜ-FƏRYAD	f.;
