DÖL	is.;
DÖLLÜK	sif.;
DÖLLƏN	f.;
DÖLLƏNDİR	f.;
DÖLLƏNDİRMƏ	f.;
DÖLLƏNDİRMƏK	f.;
DÖLLƏNDİRİL	f.;
DÖLLƏNDİRİLMƏ	f.;
DÖLLƏNDİRİLMƏK	f.;
DÖLLƏNMƏ	f.;
DÖLLƏNMƏK	f.;
DÖLMƏ	is.;
DÖLMƏLİ	sif.;
DÖLSALAN	is.;
DÖLSÜZ	sif.;
DÖLSÜZLÜK	is.;
DÖLSÜZLƏN	f.;
DÖLSÜZLƏNDİR	f.;
DÖLSÜZLƏNDİRMƏ	f.;
DÖLSÜZLƏNDİRMƏK	f.;
DÖLSÜZLƏNDİRİL	f.;
DÖLSÜZLƏNDİRİLMƏ	f.;
DÖLSÜZLƏNDİRİLMƏK	f.;
DÖLSÜZLƏNMƏ	f.;
DÖLSÜZLƏNMƏK	f.;
DÖLSÜZLƏŞ	f.;
DÖLSÜZLƏŞDİR	f.;
DÖLSÜZLƏŞDİRMƏ	f.;
DÖLSÜZLƏŞDİRMƏK	f.;
DÖLSÜZLƏŞDİRİL	f.;
DÖLSÜZLƏŞDİRİLMƏ	f.;
DÖLSÜZLƏŞDİRİLMƏK	f.;
DÖLSÜZLƏŞMƏ	f.;
DÖLSÜZLƏŞMƏK	f.;
DÖLVERİCİ	sif.;
DÖLVERİCİLİK	is.;
DÖLYANI	is.;
DÖLÇÜ	is.;
DÖLÇÜLÜK	is.;
