DÖY	f.;
DÖY-SINDIR	f.;zer.;
DÖYCƏ	is.;
DÖYCƏLƏMƏ	f_is.;
DÖYCƏLƏMƏK	f.;
DÖYCƏLƏTMƏK	icb.;
DÖYDÜR	f.;
DÖYDÜRMƏ	f.;
DÖYDÜRT	f.;
DÖYDÜRTMƏ	f.;
DÖYDÜRÜL	f.;
DÖYDÜRÜLMƏ	f.;
DÖYMƏ	f.;
DÖYMƏ-ŞTAMPLAMA	is.;
DÖYMƏC	is.;
DÖYMƏCƏ	is.;
DÖYMƏDÖŞƏMƏ	is.;
DÖYMƏGİL	is.;
DÖYMƏK	f.;zer.;
DÖYMƏKABAB	is.;
DÖYMƏLİK	sif.;
DÖYMƏNAXIŞ	is.;
DÖYMƏNAXIŞÇI	is.;
DÖYMƏQİYMƏ	is.;
DÖYÇƏLƏ	f.;
DÖYÇƏLƏMƏ	f.;
DÖYÇƏLƏN	f.;
DÖYÇƏLƏNMƏ	f.;
DÖYÇƏLƏT	f.;
DÖYÇƏLƏTMƏ	f.;
DÖYÜK	f.;
DÖYÜKDÜR	f.;
DÖYÜKDÜRMƏ	f.;
DÖYÜKDÜRMƏK	f.;
DÖYÜKMÜŞ	zer.;f.sif.;
DÖYÜKMƏ	f.;
DÖYÜKMƏK	zer.;f.;
DÖYÜL	f.;
DÖYÜLMÜŞ	f.;
DÖYÜLMƏ	f.;
DÖYÜLMƏK	f.;
DÖYÜLÜŞ	is.;
DÖYÜLƏBİLƏN	f_sif.;
DÖYÜM	is.;
DÖYÜMDAŞI	is.;
DÖYÜN	is.;
DÖYÜNDÜR	f.;
DÖYÜNDÜRMƏ	f.;
DÖYÜNDÜRMƏK	f.;
DÖYÜNMƏ	f.;
DÖYÜNMƏK	f.;
DÖYÜNTÜ	is.;
DÖYÜNÇÜ	is.;
DÖYÜNÇÜLÜK	is.;
DÖYÜNÇİÇƏYİ	is.;
DÖYÜŞ	is.;
DÖYÜŞ-SÖYÜŞ	is.;
DÖYÜŞARASI	is.;
DÖYÜŞDÜR	f.;
DÖYÜŞDÜRMƏ	f.;
DÖYÜŞDÜRMƏK	f.;
DÖYÜŞDÜRÜL	f.;
DÖYÜŞDÜRÜLMƏ	f.;
DÖYÜŞDÜRÜLMƏK	f.;
DÖYÜŞDƏNÇIXMA	is.;
DÖYÜŞKƏN	sif.;
DÖYÜŞKƏNLİK	is.;
DÖYÜŞKƏNLƏR	sif.;
DÖYÜŞLƏRARASI	is.;
DÖYÜŞMƏ	f.;
DÖYÜŞMƏK	f.;
DÖYÜŞQABAĞI	sif.;
DÖYÜŞSÜZ	zer.;
DÖYÜŞÇÜ	is.;
DÖYÜŞÇÜLÜK	is.;
DÖYÜŞƏ-DÖYÜŞƏ	zer.;
DÖYÜŞƏGİRMƏ	is.;
DÖYÜŞƏN	f_sif.;
DÖYƏC	is.;
DÖYƏCAĞI	is.;
DÖYƏCDAŞI	is.;
DÖYƏCLƏ	f.;
DÖYƏCLƏMƏ	f.;
DÖYƏCLƏMƏK	f.;
DÖYƏCLƏN	f.;
DÖYƏCLƏNMƏ	f.;
DÖYƏCLƏNMƏK	f.;
DÖYƏCÇİ	is.;
DÖYƏCƏ	is.;
DÖYƏNƏK	f.;sif.;
DÖYƏNƏKALTI	is.;
DÖYƏNƏKAYAQLI	sif.;
DÖYƏNƏKLİ	sif.;
DÖYƏNƏKLƏ	f.;
DÖYƏNƏKLƏMƏ	f.;
DÖYƏNƏKOTU	is.;
