DÜŞ	f.;
DÜŞAXƏ	is.;
DÜŞBƏRƏ	is.;
DÜŞBƏRƏBÜKƏN	is.;
DÜŞBƏRƏKƏSƏN	is.;
DÜŞBƏRƏLİK	sif.;
DÜŞBƏRƏXANA	is.;
DÜŞBƏRƏXOR	is.;
DÜŞDÜR	f.;
DÜŞDÜRMƏ	f.;
DÜŞDÜRMƏK	f.;
DÜŞHADÜŞ	is.;zer.;
DÜŞKÜ	is.;
DÜŞKÜN	sif.;
DÜŞKÜNLÜK	is.;
DÜŞKÜNLƏŞ	f.;
DÜŞKÜNLƏŞMİŞ	f.;
DÜŞKÜNLƏŞMƏ	f.;
DÜŞKÜNLƏŞMƏK	f.;
DÜŞMƏ	f.;sif.;
DÜŞMƏK	f.;
DÜŞMƏLİ	sif.;
DÜŞMƏN	f.;
DÜŞMƏN-RƏQİB	is.;
DÜŞMƏNANƏ	sif.;zer.;
DÜŞMƏNCƏ	is.;
DÜŞMƏNCƏ(SİNƏ)	zer.;
DÜŞMƏNCƏSİNƏ	zer.;
DÜŞMƏNLİK	is.;
DÜŞMƏNÇİLİK	is.;
DÜŞVAR	sif.;
DÜŞÜB-QAL	f.;
DÜŞÜK	is.;
DÜŞÜKLÜK	is.;
DÜŞÜM	is.;
DÜŞÜM	is.;
DÜŞÜMLÜ	sif.;
DÜŞÜMLÜLÜK	is.;
DÜŞÜMSÜZ	sif.;
DÜŞÜMSÜZLÜK	is.;
DÜŞÜN	f.;
DÜŞÜNCƏ	is.;
DÜŞÜNCƏLİ	sif.;
DÜŞÜNCƏLİLİK	is.;
DÜŞÜNCƏSİZ	sif.;
DÜŞÜNCƏSİZLİK	is.;
DÜŞÜNDÜR	f.;
DÜŞÜNDÜRMƏ	f.;
DÜŞÜNDÜRMƏK	f.;
DÜŞÜNDÜRÜCÜ	sif.;
DÜŞÜNMƏ	f.;
DÜŞÜNMƏDƏN	f_bag.;
DÜŞÜNMƏK	f.;
DÜŞÜNÜB-DAŞIN	f.;
DÜŞÜNÜCÜ	sif.;
DÜŞÜNÜL	f.;
DÜŞÜNÜLMÜŞ	f.;
DÜŞÜNÜLMƏ	f.;
DÜŞÜNÜLMƏK	f.;
DÜŞÜNÜŞ	is.;
DÜŞÜNÜŞMƏ	f.;
DÜŞÜNÜŞMƏK	f.;
DÜŞÜNƏ-DÜŞÜNƏ	zer.;
DÜŞÜR	f.;
DÜŞÜRDÜL	f.;
DÜŞÜRDÜLMƏ	f.;
DÜŞÜRDÜLMƏK	f.;
DÜŞÜRMƏ	f.;
DÜŞÜRMƏK	zer.;f.;
DÜŞÜRT	f.;
DÜŞÜRTMƏ	f.;
DÜŞÜRTMƏK	f.;
DÜŞÜRÜL	f.;
DÜŞÜRÜLMƏ	f.;
DÜŞÜRÜLMƏK	f.;
DÜŞƏNBƏ	is.;
DÜŞƏR-DÜŞMƏZ	zer.;
DÜŞƏRGAH	is.;
DÜŞƏRGƏ	is.;
DÜŞƏRGƏ	is.;
DÜŞƏRGƏARASI	is.;
DÜŞƏRGƏDAXİLİ	sif.;
DÜŞƏRGƏDAŞ	is.;
DÜŞƏRLİ	sif.;
DÜŞƏRİNƏ	zer.;
