DƏF	f.;is.;
DƏF	is.;
DƏF-DUMBUL	is.;
DƏFEDİLMƏZ	sif.;
DƏFETMƏ	f.;
DƏFN	is.;
DƏFNETMƏ	f.;is.;
DƏFNOLUNMAMAZLIQ	is.;
DƏFNOLUNMAZLIQ	is.;
DƏFNƏ	is.;
DƏFNƏGİLAS	is.;
DƏFNƏGİLƏNAR	is.;
DƏFNƏKİMİ	sif.;
DƏFQAYIRAN	is.;
DƏFTƏR	is.;
DƏFTƏR-QƏLƏM	is.;
DƏFTƏR-ÇƏRƏKƏ	top.;
DƏFTƏRDAR	is.;
DƏFTƏRDARLIQ	is.;
DƏFTƏRQAZI	is.;
DƏFTƏRXANA	is.;
DƏFTƏRXANAÇI	is.;
DƏFTƏRXANAÇILIQ	is.;
DƏFTƏRÇİ	is.;
DƏFTƏRÇİLİK	is.;
DƏFTƏRÇƏ	is.;
DƏFÇALAN	is.;
DƏFÇİ	is.;
DƏFÇİLİK	is.;
DƏFİNƏ	is.;
DƏFİNƏLİ	sif.;
DƏFİNƏLİK	is.;
DƏFƏ	zer.;
DƏFƏ-DARAQ	is.;
DƏFƏATLA	f.;
DƏFƏLİK	is.;
DƏFƏLƏRLƏ	zer.;
DƏFƏTƏN	zer.;
