DƏL	f.;
DƏLALƏT	is.;
DƏLBƏND	is.;
DƏLDİR	f.;
DƏLDİRMƏ	f.;
DƏLDİRMƏK	f.;
DƏLDİRT	f.;
DƏLDİRTMƏ	f.;
DƏLDİRİL	f.;
DƏLDİRİLMƏ	f.;
DƏLDİRİLMƏK	f.;
DƏLLAL	is.;
DƏLLALBAZAR	is.;
DƏLLALBAŞI	is.;
DƏLLALHAQQI	is.;
DƏLLALLIQ	is.;
DƏLLƏK	is.;
DƏLLƏKLİK	is.;
DƏLLƏKXANA	is.;
DƏLMƏ	f.;
DƏLMƏ-DEŞİK	sif.;
DƏLMƏGÖZ	is.;
DƏLMƏGÖZ(LÜ)	sif.;
DƏLMƏK	f.;
DƏLMƏKEŞ	is.;
DƏLMƏKÇƏ	is.;
DƏLİ	sif.;
DƏLİ-DOLU	sif.;
DƏLİ-DOLULUQ	is.;
DƏLİ-DİVANƏ	sif.;
DƏLİ-DİVANƏLİK	is.;
DƏLİ-QUDURMUŞ	is.;
DƏLİ-QUDURMUŞLUQ	is.;
DƏLİBALDIRĞAN	is.;
DƏLİBAŞ	sif.;
DƏLİBAŞLIQ	is.;
DƏLİBOY	is.;
DƏLİBUĞDA	is.;
DƏLİBÖYÜRTKƏN	is.;
DƏLİBƏNG	is.;
DƏLİCİ	is.;sif.;
DƏLİCİNCİLİM	is.;
DƏLİCƏ	sif.;zer.;
DƏLİCƏBUĞDA	is.;
DƏLİCƏOTU	is.;
DƏLİCƏSİNƏ	zer.;
DƏLİGİLAS	is.;
DƏLİK	sif.;
DƏLİK-DEŞİK	sif.;
DƏLİK-DEŞİKLİ	sif.;
DƏLİK-DƏLİK	zer.;
DƏLİKAÇAN	is.;
DƏLİKDEŞƏN	is.;
DƏLİKLİ	sif.;
DƏLİKÇİÇƏK	is.;
DƏLİKÜNCÜT	is.;
DƏLİL	is.;
DƏLİL-DƏLALƏT	is.;
DƏLİL-SÜBUT	is.;
DƏLİLLİ	sif.;
DƏLİLLİ-SÜBUTLU	sif.;
DƏLİLLƏŞ	f.;
DƏLİLLƏŞDİR	f.;
DƏLİLLƏŞDİRMƏ	f.;
DƏLİLLƏŞDİRMƏK	f.;
DƏLİLLƏŞDİRİL	f.;
DƏLİLLƏŞDİRİLMƏ	f.;
DƏLİLLƏŞDİRİLMƏK	f.;
DƏLİLLƏŞMƏ	f.;
DƏLİLLƏŞMƏK	f.;
DƏLİLSİZ	sif.;
DƏLİLSİZ-SÜBUTSUZ	sif.;
DƏLİLSİZLİK	is.;
DƏLİLİK	is.;
DƏLİLƏŞ	f.;
DƏLİLƏŞMƏ	f.;
DƏLİLƏŞMƏK	f.;
DƏLİN	f.;
DƏLİNMƏ	f.;
DƏLİNMƏK	f.;
DƏLİOTU	is.;
DƏLİPİŞPİŞİ	is.;
DƏLİQANLI	is.;sif.;
DƏLİQANLILIQ	is.;
DƏLİQANLIQ	is.;
DƏLİQARIN	sif.;
DƏLİSOV	sif.;
DƏLİSOVLUQ	is.;
DƏLİSOY	sif.;
DƏLİSOYLUQ	is.;
DƏLİTƏHƏR	sif.;
DƏLİTƏRƏ	is.;
DƏLİVAR	sif.;zer.;
DƏLİXANA	is.;
DƏLİXAY	sif.;zer.;
DƏLİXAYLIQ	is.;
DƏLİXİYAR	sif.;zer.;
DƏLİXƏK	f.;is.;sif.;
DƏLİXƏKLİK	is.;
DƏLİZOĞAL	is.;
DƏLİÇİÇƏK	is.;
DƏLİÇƏTƏNƏ	is.;
DƏLƏ	is.;
DƏLƏDUZ	sif.;
DƏLƏDUZCASINA	zer.;
DƏLƏDUZLUQ	is.;
DƏLƏGEY	sif.;
DƏLƏGEYLİK	is.;
DƏLƏKİMİ	sif.;
DƏLƏMƏ	is.;
DƏLƏMƏLƏN	f.;
DƏLƏMƏLƏNDİR	f.;
DƏLƏMƏLƏNDİRMƏ	f.;
DƏLƏMƏLƏNDİRMƏK	f.;
DƏLƏMƏLƏNDİRİL	f.;
DƏLƏMƏLƏNDİRİLMƏ	f.;
DƏLƏMƏLƏNDİRİLMƏK	f.;
DƏLƏMƏLƏNMƏ	f.;
DƏLƏMƏLƏNMƏK	f.;
DƏLƏNGAVAZ	sif.;
DƏLƏNGAVAZLIQ	is.;
DƏLƏNÇİK	is.;
DƏLƏQARIN	f.;is.;sif.;
DƏLƏQARINLILIQ	is.;
DƏLƏQARINLIQ	is.;
