EHTİKAR	is.;
EHTİKARLIQ	is.;
EHTİKARÇI	is.;
EHTİKARÇILIQ	is.;
EHTİMAL	is.;
EHTİMALLA	f.;
EHTİMALLI	sif.;
EHTİMALİ	sif.;
EHTİMAM	is.;
EHTİMAMKAR	sif.;
EHTİRAM	is.;
EHTİRAMLA	zer.;
EHTİRAMLI	sif.;
EHTİRAMLILIQ	is.;
EHTİRAMSIZ	sif.;
EHTİRAMSIZCA	zer.;
EHTİRAMSIZCASINA	zer.;
EHTİRAMSIZLIQ	is.;
EHTİRAMƏN	zer.;
EHTİRAQ	is.;
EHTİRAS	f.;
EHTİRASLA	f.;zer.;
EHTİRASLI	sif.;
EHTİRASLILIQ	is.;
EHTİRASSIZ	sif.;zer.;
EHTİRASSIZLIQ	is.;
EHTİVA	is.;
EHTİYAC	is.;
EHTİYACLI	sif.;
EHTİYACLILIQ	is.;
EHTİYACSIZ	zer.;
EHTİYACSIZLIQ	is.;
EHTİYAT	is.;
EHTİYATKAR	sif.;zer.;
EHTİYATKARANƏ	zer.;
EHTİYATKARLIQ	is.;
EHTİYATKARLIQLA	zer.;
EHTİYATLA	zer.;
EHTİYATLAN	f.;
EHTİYATLANMAQ	f.;
EHTİYATLI	sif.;zer.;
EHTİYATLILIQ	is.;
EHTİYATSIZ	sif.;
EHTİYATSIZCA	zer.;
EHTİYATSIZCASINA	zer.;
EHTİYATSIZLIQ	is.;
EHTİYATSIZLIQLA	zer.;
EHTİZAZ	is.;
EHTİŞAM	is.;
EHTİŞAMLA	zer.;
EHTİŞAMLI	sif.;
EHTİŞAMLILIQ	is.;
