EŞİDİL	f.;
EŞİDİLMƏ	f.;
EŞİDİLMƏK	f.;
EŞİDİLMƏZ	sif.;zer.;
EŞİDİLMƏZLİK	is.;
EŞİDİMLİ	f.;
EŞİDƏN	is.;
EŞİDƏR-EŞİTMƏZ	zer.;
EŞİK	f.;
EŞİKAĞASI	is.;
EŞİKAĞASIBAŞI	is.;
EŞİKAĞASIBAŞILIQ	is.;
EŞİKAĞASILIQ	is.;
EŞİKLİ	sif.;
EŞİL	f.;
EŞİLMƏ	f.;
EŞİLMƏK	f.;
EŞİM	is.;
EŞİM-EŞİM	sif.;
EŞİMLİK	is.;
EŞİT	f.;
EŞİTDİR	f.;
EŞİTDİRMƏ	f.;
EŞİTDİRMƏK	f.;
EŞİTDİRİL	f.;
EŞİTDİRİLMƏ	f.;
EŞİTDİRİLMƏK	f.;
EŞİTMƏ	f.;
EŞİTMƏK	f.;
EŞİTMƏMƏZLİK	is.;
EŞİTMƏZLİK	is.;
