FARA	is.;
FARAALTI	is.;
FARAD	is.;
FARADOMETR	is.;
FARADİZASİYA	is.;
FARAĞAT	sif.;zer.;
FARAĞAT-FARAĞAT	zer.;
FARAĞATLA	f.;
FARAĞATLAN	f.;
FARAĞATLAŞ	f.;
FARAĞATLIQ	is.;
FARAŞ	sif.;zer.;
FARAŞLIQ	is.;
FARMAKOKİMYA	is.;
FARMAKOLOJİ	sif.;
FARMAKOPEYA	is.;
FARMAKOTERAPİYA	is.;
FARMAZON	sif.;
FARMAZONLUQ	is.;
FARS	is.;
FARS	is.;
FARSCA	sif.;zer.;
FARSDİLİ	is.;
FARSLAŞ	f.;
FARSLAŞDIRIL	f.;
FARSLAŞDIRMAQ	f.;
FARSLAŞMAQ	f.;
FARSÇILIQ	is.;
FARSİ	is.;
FARTİNQ	is.;
FARVATER	is.;
FARİNGİT	is.;
