FIR	is.;
FIR-FIR	zer.;
FIRFIRA	is.;
FIRILDA	f.;
FIRILDAMAQ	f.;
FIRILDAN	f.;
FIRILDAQ	is.;
FIRILDAQÇI	is.;
FIRILDAQÇILIQ	is.;
FIRILDAT	f.;
FIRILDATMAQ	f.;
FIRILDAŞ	f.;
FIRILTI	is.;
FIRIN	is.;
FIRIQ	sif.;zer.;
FIRLA	f.;
FIRLADIL	f.;
FIRLAMAQ	f.;
FIRLAN	f.;
FIRLANA-FIRLANA	zer.;
FIRLANCAQ	is.;
FIRLANDIR	f.;
FIRLANDIRICI	sif.;
FIRLANDIRIL	f.;
FIRLANDIRMAQ	f.;
FIRLANMAQ	f.;
FIRLANQAC	is.;
FIRLANĞIC	is.;
FIRLAQ	is.;
FIRLAT	f.;
FIRLATMAQ	f.;
FIRLAYIŞ	is.;
FIRLAÇAMA	is.;
FIRLAĞAN	is.;
FIRLI	sif.;
FIRT	is.;
FIRTINA	f.;
FIRTINALI	sif.;
FIRTINALILIQ	is.;
FIRTINAQUŞU	is.;
FIRTINASIZ	sif.;
FIRTIQ	is.;
FIRTIQLI	sif.;
FIRTIQLILIQ	is.;
FIRÇA	is.;
FIRÇALA	f.;
FIRÇALAN	f.;
FIRÇAOTU	is.;
FIRÇATUTAN	is.;
FIRÇAVARI	sif.;
FIRÇAVARILIQ	is.;
FIRÇAYABƏNZƏR	sif.;
FIRÇAŞƏKİLLİ	sif.;
FIRÇILDA	f.;
FIRÇILDAMAQ	f.;
FIRÇILDAT	f.;
FIRÇILTI	is.;
