FOT	is.;
FOTOAKTİV	sif.;
FOTOALBOM	is.;
FOTOALICI	is.;
FOTOARTIRICI	sif.;
FOTOAVTOMÜFƏTTİŞ	is.;
FOTOBATAREYA	is.;
FOTOBAYRAM	is.;
FOTOBLOK	is.;
FOTOBÖYÜDÜCÜ	is.;
FOTOBÜLLETEN	is.;
FOTOBİOKİMYA	is.;
FOTOBİOLOGİYA	is.;
FOTOBİOLOJİ	sif.;
FOTOCƏRƏYAN	is.;
FOTODİOD	is.;
FOTODİSK	is.;
FOTOEFFEKT	is.;
FOTOEKRAN	is.;
FOTOEKSPOZİSİYA	is.;
FOTOELASTİK	sif.;
FOTOELEKTROD	is.;
FOTOELEKTRON	is.;
FOTOELEKTRİK	is.;
FOTOEMULSİYA	is.;
FOTOETÜD	is.;
FOTOFAKSİMİLE	is.;
FOTOFAKT	is.;
FOTOFAZA	is.;
FOTOFON	is.;
FOTOFONİK	sif.;
FOTOFİLM	is.;
FOTOFİZİOLOQ	is.;
FOTOGEN	is.;
FOTOGENERATOR	is.;
FOTOGENİK	sif.;
FOTOGÜCLƏNDİRİCİ	sif.;
FOTOHELİOQRAF	is.;
FOTOHİDROLİZ	is.;
FOTOHƏSSAS	sif.;
FOTOHƏSSASLIQ	is.;
FOTOHƏVƏSKAR	is.;
FOTOJURNALİST	is.;
FOTOKAMERA	is.;
FOTOKARTOÇKA	is.;
FOTOKATOD	is.;
FOTOKAĞIZ	is.;
FOTOKEÇİRİCİLİK	is.;
FOTOKLUB	is.;
FOTOKLUBLARARASI	sif.;
FOTOKOMPOZİSİYA	is.;
FOTOKÖŞK	is.;
FOTOKİMYƏVİ	sif.;
FOTOKİNORENTGEN	is.;
FOTOKİTAB	is.;
FOTOKƏŞFİYYAT	is.;
FOTOLENT	is.;
FOTOLÖVHƏ	is.;
FOTOLÜMİNESSENSİYA	is.;
FOTOLİTOQRAFİK	sif.;
FOTOMETRİK	sif.;
FOTOMEXANİK	is.;
FOTOMEXANİKİ	sif.;
FOTOMODEL	is.;
FOTOMONOQRAFİYA	is.;
FOTOMONTAJÇI	is.;
FOTOMOZAİKA	is.;
FOTOMÜNTƏXƏBAT	is.;
FOTOMÜQAVİMƏT	is.;
FOTOMÜSABİQƏ	is.;
FOTOMÜXBİR	f.;is.;
FOTOMÜŞAHİDƏ	is.;
FOTOMÜŞAHİDƏÇİLİK	is.;
FOTON	is.;
FOTONABOR	is.;
FOTONEQATİV	sif.;
FOTOOFORT	is.;
FOTOOV	is.;
FOTOOVÇU	is.;
FOTOOÇERK	is.;
FOTOPANORAM	is.;
FOTOPARÇA	is.;
FOTOPEYZAJ	is.;
FOTOPLAKAT	is.;
FOTOPLAN	is.;
FOTOPLASTİNKA	is.;
FOTOPLYONKA	is.;
FOTOPORTRET	is.;
FOTOPƏNCƏRƏ	is.;
FOTOQEYD	is.;
FOTOQEYDETMƏ	f.;
FOTOQRAFLA	f.;
FOTOQRAFLAN	f.;
FOTOQRAFLIQ	is.;
FOTOQRAFÇI	f.;is.;
FOTOQRAFÇILIQ	is.;
FOTOQRAFİK	sif.;
FOTOQRAM	is.;
FOTOQRAMMETRİK	f.;
FOTOQRAMMETRİYA	is.;
FOTOQRAVÜRA	is.;
FOTOQƏZET	is.;
FOTOREAKSİYA	is.;
FOTOREAKTİV	f.;
FOTOREKLAM	is.;
FOTORELE	is.;
FOTOREPORTYOR	f.;
FOTOREPRODUKSİYA	is.;
FOTORESEPTOR	is.;
FOTOREZİSTOR	is.;
FOTOSALNAMƏ	is.;
FOTOSALON	is.;
FOTOSEVƏR	is.;
FOTOSFER	is.;
FOTOSKOP	is.;
FOTOSTEND	is.;
FOTOSTUDİYA	is.;
FOTOSXEM	is.;
FOTOSİNTETİK	is.;
FOTOSİNTEZ	is.;
FOTOSİNTEZLƏŞDİRMƏ	f.;
FOTOSƏNƏD	is.;
FOTOSƏNƏDLİ	sif.;
FOTOSƏRGİ	is.;
FOTOTELEFON	is.;
FOTOTELEQRAFİYA	is.;
FOTOTELEVİZİYA	is.;
FOTOTEXNOLOGİYA	is.;
FOTOTEXNOLOQ	is.;
FOTOTEXNİK	is.;
FOTOTEXNİKA	is.;
FOTOTOPOQRAFİYA	is.;
FOTOTRANSFORMATOR	is.;
FOTOTRANZİSTOR	is.;
FOTOTROPİK	sif.;
FOTOTROPİZM	is.;
FOTOTİPÇİ	is.;
FOTOTİPİYA	is.;
FOTOTƏBƏQƏ	is.;
FOTOTƏRTİB	is.;
FOTOTƏSVİR	is.;
FOTOTƏSİRLƏNMƏ	f.;
FOTOVİTRİN	is.;
FOTOÇƏKMƏ	f.;
FOTOİNFORMASİYA	is.;
FOTOİTTİHAM	is.;
FOTOŞƏKİLÇƏKMƏ	f.;
FOTOƏSƏR	is.;
