GEOAKUSTİKA	is.;
GEOANTİKLİNAL	sif.;
GEOBALLİSTİK	sif.;
GEOBAROMETR	is.;
GEOBOTANİK	sif.;
GEOBOTANİKİ	sif.;
GEODEZİK	sif.;
GEODEZİYA	is.;
GEODEZİYAÇI	is.;
GEODİMETRİYA	is.;
GEODİNAMİK	sif.;
GEODİNAMİKA	is.;
GEODİOTROPİZM	sif.;
GEOFAZA	is.;
GEOFON	is.;
GEOFİT	sif.;
GEOFİZİKİ	sif.;
GEOGİGİYENA	is.;
GEOHİDRODİNAMİK	sif.;
GEOKOMPLEKS	is.;
GEOKOSMİK	sif.;
GEOKRATİK	sif.;
GEOKRİOLOGİYA	is.;
GEOKİMYAÇI	is.;
GEOLOJİ	sif.;
GEOLOJİ-COĞRAFİ	sif.;
GEOLOJİ-GENETİK	sif.;
GEOLOJİ-GEOFİZİKİ	sif.;
GEOLOJİ-GEOKİMYƏVİ	sif.;
GEOLOJİ-GEOMORFOLOJİ	sif.;
GEOLOJİ-HİDROGEOLOJİ	sif.;
GEOLOJİ-HİDROLOJİ	sif.;
GEOLOJİ-KƏŞFİYYAT	is.;
GEOLOJİ-PLANAALMA	is.;
GEOLOJİ-STRUKTUR	is.;
GEOLOJİ-TEXNİKİ	sif.;
GEOLOKATOR	is.;
GEOLOQ-PALEONTOLOQ	is.;
GEOLOQ-TOPOQRAF	is.;
GEOMAQNETİZM	is.;
GEOMAQNİT	is.;
GEOMAQNİTOFON	is.;
GEOMETR	is.;
GEOMOR	is.;
GEOMORFOLOJİ	sif.;
GEOMORFOLOQ	is.;
GEOMİKROBİOLOGİYA	is.;
GEOMİKROBİOLOJİ	sif.;
GEOPOTENSİAL	is.;
GEORADİOKİMYA	is.;
GEORADİOKİMYƏVİ	sif.;
GEORGİN	is.;
GEOSENTRİK	sif.;
GEOSENTRİZM	is.;
GEOSFER	is.;
GEOSİNKLİNAL	is.;
GEOSİYASİ	sif.;
GEOSİYASƏT	is.;
GEOTEKTONİK	sif.;
GEOTEKTONİKA	is.;
GEOTERMAL	is.;
GEOTERMOMETR	is.;
GEOTERMİK	sif.;
GEOTERMİKA	is.;
GEOTERMİST	is.;
GEOTERMİYA	is.;
GEOTEXNOLOGİYA	is.;
GEOTEXNOLOJİ	sif.;
GEOTEXNİK	is.;
GEOTEXNİKA	is.;
GEOTEXNİKİ	sif.;
GEOTROPİZM	is.;
GEOXRONOLOGİYA	is.;
GEOXRONOLOJİ	sif.;
GEOİD	is.;
