GƏM	is.;
GƏM	is.;
GƏMALMASI	is.;
GƏMLƏ	f.;
GƏMLƏMƏ	f_is.;
GƏMLƏMƏK	f.;
GƏMLƏNMƏ	f.;
GƏMLƏNMƏK	f.;
GƏMLƏT	f.;
GƏMLƏTMƏ	f.;
GƏMİ	is.;
GƏMİ-BƏRƏ	is.;
GƏMİ-KRAN	is.;
GƏMİ-LABORATORİYA	is.;
GƏMİ-PEYK	is.;
GƏMİCİK	is.;
GƏMİDAXİLİ	sif.;
GƏMİK	is.;
GƏMİKLİ	sif.;
GƏMİLİK	is.;
GƏMİLƏRARASI	sif.;
GƏMİQALDIRICI	sif.;
GƏMİQALDIRMA	is.;
GƏMİQAYA	is.;
GƏMİQAYIRAN	is.;
GƏMİQAYIRMA	is.;
GƏMİQURDU	is.;
GƏMİR	f.;
GƏMİRCƏK	is.;
GƏMİRMƏ	f.;
GƏMİRMƏK	f.;
GƏMİRT	f.;
GƏMİRTLƏ	f.;
GƏMİRTLƏMƏ	f.;
GƏMİRTLƏMƏK	f.;
GƏMİRTLƏN	f.;
GƏMİRTLƏNMİŞ	f.;
GƏMİRTLƏNMƏ	f.;
GƏMİRTLƏNMƏK	f.;
GƏMİRTMƏ	f.;
GƏMİRİCİ	sif.;
GƏMİRİCİLƏR	is.;
GƏMİRİK	sif.;
GƏMİRİKLƏMƏ	f.;
GƏMİRİKLƏMƏK	f.;
GƏMİRİL	f.;
GƏMİRİLMİŞ	f.;
GƏMİRİLMƏ	f.;
GƏMİRİLMƏK	f.;
GƏMİRİNTİ	is.;
GƏMİRİŞ	f.;
GƏMİRİŞDİR	f.;
GƏMİRİŞDİRMƏ	f.;
GƏMİRİŞDİRMƏK	f.;
GƏMİRİŞMƏ	f.;
GƏMİRİŞMƏK	f.;
GƏMİRƏ-GƏMİRƏ	zer.;
GƏMİÇİ	is.;
GƏMİÇİLİK	is.;
GƏMİİDARƏETMƏ	f.;
GƏMİŞ	f.;
GƏMİŞDİR	f.;
GƏMİŞDİRMƏ	f.;
GƏMİŞDİRMƏK	f.;
GƏMİŞMƏ	f.;
GƏMİŞMƏK	f.;
GƏMƏ	is.;
