HÖVKƏ	is.;
HÖVKƏLƏ	f.;
HÖVKƏLƏMƏ	f_is.;
HÖVKƏLƏMƏK	f.;
HÖVKƏLƏN	f.;
HÖVKƏLƏNMİŞ	f_sif.;
HÖVKƏLƏNMƏ	f.;
HÖVL	is.;
HÖVLNAK	zer.;
HÖVLNAKLIQ	is.;
HÖVLƏKİ	zer.;
HÖVLƏKİLİK	is.;
HÖVOTU	is.;
HÖVSƏ	is.;
HÖVSƏLƏ	is.;
HÖVSƏLƏLİ	zer.;sif.;
HÖVSƏLƏLİLİK	is.;
HÖVSƏLƏMƏ	f_is.;
HÖVSƏLƏMƏK	f.;
HÖVSƏLƏSİZ	zer.;sif.;
HÖVSƏLƏSİZLİK	is.;
HÖVSƏMƏ	f_is.;
HÖVSƏMƏK	f.;
HÖVSƏR	is.;
HÖVSƏRLƏ	f.;
HÖVSƏRLƏMƏ	f.;
HÖVSƏRLƏN	f.;
HÖVSƏRLƏNMƏ	f.;
HÖVZƏ	is.;
HÖVZƏ	is.;
HÖVZƏARASI	sif.;
