KOR	sif.;
KOR-KAR	sif.;
KOR-KAR-LAL	sif.;
KOR-KAR-LALLIQ	is.;
KOR-KOBUD	sif.;
KOR-KORANƏ	zer.;
KOR-PEŞMAN	zer.;
KOR-PEŞMANLIQ	is.;
KOR-PEŞMANÇILIQ	is.;
KORA	is.;
KORABUĞUM	is.;
KORAFƏHM	is.;
KORAFƏHMLİK	is.;
KORALA	f.;
KORALAN	f.;
KORALAT	f.;
KORAMAL	is.;
KORAMALOTU	is.;
KORAMAZ	is.;
KORAZAL	is.;
KORAZEHİN	is.;
KORAZEHİNLİK	is.;
KORBAĞIRSAQ	is.;
KORBUCAQ	is.;
KORBUCAQ(LI)	is.;sif.;
KORBUCAQLI	sif.;
KORBUZ	sif.;
KORCA(SINA)	zer.;
KORCASINA	zer.;
KORCUĞAZ	sif.;
KORD	is.;
KORDA	is.;
KORDABALET	is.;
KORDAİT	is.;
KORDELYER	is.;
KORDOBA	is.;
KORDODROM	is.;
KORDON	is.;
KORDİAMİN	is.;
KORDİYERİT	is.;
KOREOPSİS	is.;
KOREYACA	sif.;zer.;
KOREYALI	is.;
KORGÖZ	sif.;
KORLA	f.;
KORLAMAQ	f.;
KORLAN	f.;
KORLANMA	f.is.;
KORLANMAQ	f.;
KORLAT	f.;
KORLAŞ	f.;
KORLAŞMAQ	f.;
KORLUQ	is.;
KORLUQ	is.;
KORMOFİT	is.;
KORNER	is.;
KORNET	is.;
KORNETÇALAN	is.;
KORNUEL	is.;
KORNİLOVÇU	is.;
KORNİLOVÇULUQ	is.;
KOROLYOK	is.;
KORONOMETR	is.;
KORONOQRAF	is.;
KORONOVİRUS	is.;
KOROĞLU	is.;
KOROĞLUHƏNGİ	is.;
KOROĞLUSAYAĞI	zer.;
KOROĞLUYANA	zer.;
KOROĞLUŞÜNAS	is.;
KOROĞLUŞÜNASLIQ	is.;
KORPORASİYA	is.;
KORPORATİV	sif.;
KORPORATİVLİK	is.;
KORPORATİVİZM	is.;
KORPUS	is.;
KORPUSLARARASI	sif.;
KORPUSLU	sif.;
KORPUSSUZ	sif.;
KORPUSÇU	is.;
KORREKT	sif.;
KORREKTOR	is.;
KORREKTORLUQ	is.;
KORREKTURA	is.;
KORREKTURAÇI	is.;
KORRELYASİYA	is.;
KORRELYAT	is.;
KORRELYATİV	sif.;
KORRELYATİVLİK	is.;
KORRELYATİVİZM	is.;
KORRESPONDENSİYA	is.;
KORROZİMETR	is.;
KORROZİYA	is.;
KORROZİYALI	sif.;
KORROZİYAYADAVAMLI	sif.;
KORRUPSİYA	is.;
KORRUPSİYAÇI	is.;
KORRİDA	is.;
KORSAJ	is.;
KORSAR	is.;
KORSET	is.;
KORSETLİ	sif.;
KORSİKALI	is.;
KORT	is.;
KORTADERİYA	is.;
KORTALMA	is.;
KORTALT	is.;
KORTALTMA	is.;
KORTEJ	is.;
KORTES	is.;
KORTLAN	f.;
KORTLAŞ	f.;
KORTİKOSTEROİD	is.;
KORTİKOTROPİN	is.;
KORTİN	is.;
KORTİZON	is.;
KORTƏBİİ	sif.;
KORTƏBİİLİK	is.;
KORUN-KORUN	zer.;
KORUND	is.;
KORUX	f.;
KORUXMAQ	f.;
KORUŞ	is.;sif.;
KORUŞLUQ	is.;
KORVALOL	is.;
KORÇİBAN	is.;
KORİDOR	is.;
KORİDORCU	is.;
KORİDORÇU	is.;
KORİFEY	is.;
KORİNEBAKTERİOZ	is.;
KORİNEBAKTERİYA	is.;
KORİNOZOMOZ	is.;
KORİOLİS	is.;
KORŞ	is.;sif.;
KORŞALMAQ	f.;
KORŞALTMAQ	f.;
