KÖR-KÖHNƏ	sif.;
KÖR-KÖTÜR	sif.;
KÖRFƏZ	is.;
KÖRKİÇİÇƏK	is.;
KÖRPÜ	is.;
KÖRPÜ	is.;
KÖRPÜCÜK	is.;
KÖRPÜCÜK-ATLAS	is.;
KÖRPÜCÜK-DÖŞ	is.;
KÖRPÜCÜK-DİLALTI	is.;
KÖRPÜCÜKALTI	is.;
KÖRPÜCÜKARASI	sif.;
KÖRPÜCÜKÜSTÜ	sif.;
KÖRPÜLÜ	sif.;
KÖRPÜLÜ	sif.;
KÖRPÜSALAN	is.;
KÖRPÜSALMA	is.;
KÖRPÜTİKMƏ	is.;
KÖRPÜÇÜ	is.;
KÖRPƏ	sif.;
KÖRPƏCİK	is.;
KÖRPƏCİYƏZ	is.;
KÖRPƏCƏ	sif.;
KÖRPƏLİ	sif.;
KÖRPƏLİK	is.;
KÖRÜK	is.;
KÖRÜK-ZİNDAN	is.;
KÖRÜKBASAN	is.;
KÖRÜKLÜ	sif.;
KÖRÜKLƏ	f.;
KÖRÜKLƏMƏ	f.;
KÖRÜKLƏMƏK	f.;
KÖRÜKLƏN	f.;
KÖRÜKLƏNMƏ	f.;
KÖRÜKLƏNMƏK	f.;
KÖRÜKÇÜ	is.;
KÖRÜKÇÜLÜK	is.;
KÖRÜYƏBƏNZƏR	sif.;
KÖRƏMƏZ	is.;
KÖRƏMƏZLİK	is.;
