KÜS	f.;
KÜSDÜM	f.;
KÜSDÜMAĞACI	is.;
KÜSDÜMGÜLÜ	is.;
KÜSDÜMOTU	is.;
KÜSDÜMOTUKİMİLƏR	is.;
KÜSDÜR	f.;
KÜSDÜRMƏ	f.;
KÜSDÜRMƏK	f.;
KÜSKÜ	is.;
KÜSKÜN	sif.;zer.;
KÜSKÜN-KÜSKÜN	zer.;
KÜSKÜNCƏSİNƏ	zer.;
KÜSKÜNLÜK	is.;
KÜSKÜNLƏŞ	f.;
KÜSKÜNLƏŞMƏ	f.;
KÜSKÜNLƏŞMƏK	f.;
KÜSMƏ	f.;
KÜSMƏK	f.;
KÜSTAX	sif.;
KÜSTAXLIQ	is.;
KÜSTÜŞAM	is.;
KÜSÜ	is.;
KÜSÜB-BARIŞ	f.;
KÜSÜLÜ	sif.;
KÜSÜLÜLÜK	is.;
KÜSÜŞ	f.;
KÜSÜŞMƏ	f.;
KÜSÜŞMƏK	f.;
KÜSƏN	sif.;
KÜSƏNMƏ	f.;
KÜSƏNMƏK	f.;
KÜSƏYƏN	sif.;
KÜSƏYƏNLİK	is.;
