KƏPLƏ	f.;
KƏPLƏMƏ	f.;
KƏPİTKƏ	is.;
KƏPİTKƏLƏMƏ	f.;
KƏPİTKƏLƏMƏK	f.;
KƏPİTKƏLƏNMƏ	f.;
KƏPİTKƏLƏNMƏK	f.;
KƏPƏK	is.;
KƏPƏKLİ	sif.;
KƏPƏKLİLİK	is.;
KƏPƏKLƏ	f.;
KƏPƏKLƏMƏ	f.is.;
KƏPƏKLƏMƏK	f.;
KƏPƏKLƏN	f.;
KƏPƏKLƏNMƏ	f.;
KƏPƏKLƏNMƏK	f.;
KƏPƏNG	is.;
KƏPƏNƏK	is.;
KƏPƏNƏKGÜLÜ	is.;
KƏPƏNƏKLİ	sif.;
KƏPƏNƏKQURDU	is.;
KƏPƏNƏKVARI	zer.;
KƏPƏNƏKVARİ	sif.;
KƏPƏNƏKÇİÇƏK	is.;
KƏPƏNƏKÇİÇƏKLİ	sif.;
KƏPƏYİ	sif.;
