MAKAKA	is.;
MAKAO	is.;
MAKARA	is.;
MAKARAÇI	is.;
MAKARON	is.;
MAKARONİZM	is.;
MAKEDONİYA	is.;
MAKEDONİYALI	is.;
MAKEDONİYALILAR	is.;
MAKET	is.;
MAKETLƏŞDİR	f.;
MAKETLƏŞDİRMƏ	f.;
MAKETLƏŞDİRİL	f.;
MAKETLƏŞDİRİLMƏ	f.;
MAKETÇİ	is.;
MAKETÇİLİK	is.;
MAKKARTİZM	is.;
MAKREL	is.;
MAKROANALİTİK	is.;
MAKROANALİZ	is.;
MAKROAQREQAT	is.;
MAKROATMOSFER	is.;
MAKROAVTOQRAF	is.;
MAKROAVTORADİOQRAFİYA	is.;
MAKROBENTOS	is.;
MAKROBLAST	is.;
MAKROBİOTİKA	is.;
MAKRODEFORMASİYA	is.;
MAKROELEMENT	is.;
MAKROETNONİM	is.;
MAKROFAQ	is.;
MAKROFAUNA	is.;
MAKROFLORA	is.;
MAKROFON	is.;
MAKROFONEM	is.;
MAKROFORMA	is.;
MAKROFOTOQRAFİYA	is.;
MAKROHƏNDƏSƏ	is.;
MAKROKOMPONENT	is.;
MAKROKOSMOS	is.;
MAKROKRİSTAL	is.;
MAKROKİNETİKA	is.;
MAKROLANDŞAFT	is.;
MAKROLİD	is.;
MAKROLİNQVİSTİKA	is.;
MAKROLİT	is.;
MAKROMETEOROLOGİYA	is.;
MAKROMETEOROLOJİ	is.;
MAKROMEXANİKA	is.;
MAKROMEXANİKİ	sif.;
MAKROMOLEKUL	is.;
MAKROMORFOLOGİYA	is.;
MAKROMİKROSKOPİK	sif.;
MAKRONAHAMARLIQ	is.;
MAKROOBYEKT	is.;
MAKROPLANKTON	is.;
MAKROPLAST	is.;
MAKROPROQRAM	is.;
MAKROPROSES	is.;
MAKROQLİYA	is.;
MAKROQURULUŞ	is.;
MAKRORADİKAL	sif.;
MAKRORADİOQRAFİYA	is.;
MAKRORAYON	is.;
MAKRORELYEF	is.;
MAKROSEQMENT	is.;
MAKROSEYSMİK	sif.;
MAKROSKOPİK	sif.;
MAKROSNOPTİK	sif.;
MAKROSPOR	is.;
MAKROSPORİOZ	is.;
MAKROSTRUKTUR	is.;
MAKROSİSTEM	is.;
MAKROTEZAURUS	is.;
MAKROTOPONİM	is.;
MAKROTOPONİMİK	sif.;
MAKROTOPONİMİKA	is.;
MAKROTOPONİMİYA	is.;
MAKROTƏKAMÜL	is.;
MAKROVİZİR	is.;
MAKROÇƏKİLİŞ	is.;
MAKROİQLİM	is.;
MAKROİQTİSADİ	sif.;
MAKROİQTİSADİYYAT	is.;
MAKSİ-PALTO	is.;
MAKSİ-YUBKA	is.;
MAKSİM	is.;
MAKSİMAL	sif.;
MAKSİMAL-MİNİMAL	sif.;
MAKSİMALİST	is.;
MAKSİMALİZM	is.;
MAKSİMUM	sif.;
MAKULATURA	is.;
MAKVİS	is.;
MAKİ	is.;
MAKİAVELLİST	is.;
MAKİAVELLİZM	is.;
MAKİNA	is.;
MAKİNAÇI	is.;
MAKİNAÇILIQ	is.;
