MİS	is.;
MİS-AMMONYAK	is.;
MİS-KÖMÜR	is.;
MİS-MANQAN	is.;
MİS-NİKEL	is.;
MİS-QRAFİTLİ	is.;
MİS-SİNK	is.;
MİSAL	is.;
MİSALLI	sif.;
MİSALSIZ	sif.;
MİSGƏR	is.;
MİSGƏRLİK	is.;
MİSGƏRXANA	is.;
MİSKİN	sif.;
MİSKİN-MİSKİN	zer.;
MİSKİNLİK	is.;
MİSKİNLƏŞ	f.;
MİSKİNLƏŞMƏ	f.;
MİSKİNLƏŞMƏK	f.;
MİSKƏNƏ	is.;
MİSL	is.;
MİSLİ-BƏRABƏRİ	is.;
MİSLƏ	f.;
MİSLƏMƏ	f.;
MİSLƏMƏK	f.;
MİSMAR	is.;
MİSMARLA	f.;
MİSMARLAMAQ	f.;
MİSMARLAN	f.;
MİSMARLANMAQ	f.;
MİSMARLAT	f.;
MİSQAL	is.;
MİSQAL-TƏRƏZİ	is.;
MİSQALI	is.;
MİSQALI	is.;
MİSQALLI	sif.;
MİSQALLIQ	sif.;
MİSRA	is.;
MİSRALIQ	is.;
MİSRİ	sif.;
MİSRİ	sif.;
MİSS	is.;
MİSSAFLAŞDIRMA	is.;
MİSSİONER	is.;
MİSSİONERLİK	is.;
MİSSİS	is.;
MİSSİYA	is.;
MİSTER	is.;
MİSTERİYA	is.;
MİSTRAL	is.;
MİSTİFİKASİYA	is.;
MİSTİFİKASİYAÇI	is.;
MİSTİFİKASİYAÇILIQ	is.;
MİSTİK	sif.;
MİSTİKA	is.;
MİSTİKLƏŞ	f.;
MİSTİKLƏŞDİR	f.;
MİSTİKLƏŞDİRMƏ	f.;
MİSTİKLƏŞDİRİLMƏ	f.;
MİSTİKLƏŞMƏ	f.;
MİSTİSİZM	is.;
MİSTƏMİZLƏMƏ	is.;
MİSYAYAN	sif.;
MİSİA	is.;
MİSİLSİZ	sif.;
MİSİLSİZLİK	is.;
MİSİRCƏ	sif.;zer.;
MİSİRLİ	is.;
MİSİRLİLƏR	is.;
MİSİRŞÜNAS	is.;
MİSİRŞÜNASLIQ	is.;
MİSƏRİDƏN	sif.;
MİSƏRİTMƏ	is.;
