MÜFARİQƏT	is.;
MÜFLİS	is.;sif.;
MÜFLİSLİK	is.;
MÜFLİSLƏŞ	f.;
MÜFLİSLƏŞDİR	f.;
MÜFLİSLƏŞDİRMƏ	f.;
MÜFLİSLƏŞDİRMƏK	f.;
MÜFLİSLƏŞMƏ	f.;
MÜFLİSLƏŞMƏK	f.;
MÜFRƏD	is.;
MÜFSİD	sif.;
MÜFTİ	is.;
MÜFTİLİK	is.;
MÜFTƏ	sif.;zer.;
MÜFTƏCƏ	sif.;zer.;
MÜFTƏXOR	is.;sif.;
MÜFTƏXORLUQ	is.;
MÜFƏSSƏL	sif.;zer.;
MÜFƏSSƏLLİK	is.;
MÜFƏTTİŞ	is.;
MÜFƏTTİŞLİK	is.;
