MÜFTİ	is.;
MÜƏLLİF	is.;
MÜƏLLİFLİK	is.;
MÜƏLLİM	is.;
MÜƏLLİM-TƏRBİYƏÇİ	is.;
MÜƏLLİM-ŞAGİRD	is.;
MÜƏLLİMLİK	is.;
MÜƏLLİMƏ	is.;
MÜƏMMA	is.;
MÜƏMMALI	zer.;sif.;
MÜƏMMALILIQ	is.;
MÜƏMMASIZ	zer.;sif.;
MÜƏMMASIZLIQ	is.;
MÜƏNNƏS	is.;
MÜƏSSİR	sif.;
MÜƏSSİS	is.;
MÜƏSSİSAN	is.;
MÜƏSSİSƏ	is.;
MÜƏSSİSƏDAXİLİ	sif.;
MÜƏSSİSƏDƏNKƏNAR	sif.;
MÜƏSSİSƏLƏRARASI	sif.;
MÜƏTTƏR	sif.;
MÜƏYYƏN	sif.;
MÜƏYYƏNEDİCİ	sif.;
MÜƏYYƏNLİK	is.;
MÜƏYYƏNLƏŞ	f.;
MÜƏYYƏNLƏŞDİR	f.;
MÜƏYYƏNLƏŞDİRMƏ	f.;
MÜƏYYƏNLƏŞDİRMƏK	f.;
MÜƏYYƏNLƏŞDİRİL	f.;
MÜƏYYƏNLƏŞDİRİLMƏ	f.;
MÜƏYYƏNLƏŞDİRİLMƏK	f.;
MÜƏYYƏNLƏŞMƏ	f.;
MÜƏYYƏNLƏŞMƏK	f.;
MÜƏZZİN	is.;
MÜƏZZİNLİK	is.;
MÜƏZZƏM	sif.;
MÜƏŞŞƏR	is.;
