MƏT	is.;
MƏTA	is.;
MƏTANƏT	is.;
MƏTANƏTLİ	sif.;
MƏTANƏTLİLİK	is.;
MƏTANƏTSİZ	sif.;
MƏTANƏTSİZLİK	is.;
MƏTBU	sif.;
MƏTBUAT	is.;
MƏTBUATYAYIMI	is.;
MƏTBUATÇI	is.;
MƏTBƏX	is.;
MƏTBƏXLİ	sif.;
MƏTBƏXQURDU	is.;
MƏTBƏXSİZ	sif.;
MƏTBƏXXANA	sif.;
MƏTBƏXXƏRCİ	is.;
MƏTBƏƏ	is.;
MƏTBƏƏÇİ	is.;
MƏTBƏƏÇİLİK	is.;
MƏTLUB	is.;
MƏTLİ	sif.;
MƏTLƏ	is.;
MƏTLƏB	is.;
MƏTLƏBLİ	sif.;
MƏTLƏBSİZ	sif.;
MƏTLƏBSİZLİK	is.;
MƏTLƏŞ	f.;
MƏTLƏŞDİR	f.;
MƏTLƏŞDİRMƏ	f.;
MƏTLƏŞMƏ	f.;
MƏTN	is.;
MƏTNARASI	sif.;
MƏTNQABAĞI	sif.;
MƏTNİ	sif.;
MƏTNŞÜNAS	is.;
MƏTNŞÜNASLIQ	is.;
MƏTSİZ	sif.;
MƏTVARI	sif.;
MƏTVARILIQ	is.;
MƏTÇƏKƏN	is.;
MƏTİN	sif.;
MƏTİNLİK	is.;
MƏTİNLƏ	f.;
MƏTİNLƏMƏ	f.;
MƏTİNLƏŞ	f.;
MƏTİNLƏŞDİR	f.;
MƏTİNLƏŞDİRMƏ	f.;
MƏTİNLƏŞDİRMƏK	f.;
MƏTİNLƏŞMƏ	f.;
MƏTİNLƏŞMƏK	f.;
MƏTƏ	is.;
MƏTƏ-MƏTƏ	is.;
MƏTƏRƏ	is.;
