NAQABİL	sif.;
NAQAFİL	sif.;zer.;
NAQAFİLLİK	is.;
NAQAN	is.;
NAQOLAY	sif.;zer.;
NAQOLAYLIQ	is.;
NAQQABALIQ	is.;
NAQQAL	sif.;
NAQQALLA	f.;
NAQQALLAMAQ	f.;
NAQQALLAŞ	f.;
NAQQALLAŞMAQ	f.;
NAQQALLIQ	is.;
NAQQALXANA	is.;
NAQQATLIQ	is.;
NAQQAŞ	is.;
NAQQAŞKAR	is.;
NAQQAŞKARLIQ	is.;
NAQQAŞLIQ	is.;
NAQQAŞÇILIQ	is.;
NAQUS	is.;
NAQİL	is.;
NAQİLLİK	is.;
NAQİS	is.;sif.;
NAQİSLİK	is.;
NAQİSÜLƏQL	sif.;
NAQƏBUL	sif.;
