NAS	is.;
NAS	is.;
NASAZ	sif.;zer.;
NASAZLA	f.;
NASAZLAŞ	f.;
NASAZLIQ	is.;
NASEH	is.;
NASOS	is.;
NASOS-FORSUNKA	is.;
NASOSLA	f.;
NASOSLAMAQ	f.;
NASOSLAN	f.;
NASOSLU	sif.;
NASOSLUQ	is.;
NASOSXANA	is.;
NASOSÇU	is.;
NASİONAL	sif.;
NASİONAL-DEMOKRAT	is.;
NASİONAL-LEYBORİST	is.;
NASİONAL-SOSİALİST	is.;
NASİONAL-SİYASİ	sif.;
NASİR	is.;
NASİR	sif.;
NASİRANƏ	zer.;
NASİRLİK	is.;
NASİST	is.;
NASİZM	is.;
NASƏLİS	sif.;
NASƏLİSLİK	is.;
NASƏZA	sif.;
NASƏZALIQ	is.;
