OYADICI	sif.;
OYADICILIQ	is.;
OYALA	f.;
OYALAMAQ	f.;
OYALAN	f.;
OYAN	f.;
OYAN-BUYAN	zer.;
OYANA-BUYANA	zer.;
OYANDIR	f.;
OYANDIRICI	sif.;
OYANDIRMAQ	f.;
OYANIQ	sif.;
OYANIQLIQ	is.;
OYANIŞ	is.;
OYANKI	sif.;
OYANLI-BUYANLI	sif.;
OYANMAQ	f.;
OYANMAZ	f_sif.;
OYANMAZLIQ	is.;
OYAQ	sif.;
OYAQLIQ	is.;
OYAT	f.;
OYATMAQ	f.;
OYAŞ	f.;
