PAY	is.;
PAY	is.;
PAY-BÖLÜŞ	is.;
PAY-LÜŞ	is.;
PAY-PAY	zer.;
PAY-PUŞ	is.;
PAY-PİYADA	sif.;
PAYA	is.;
PAYAARASI	sif.;
PAYABASDIRAN	is.;
PAYACIQ	is.;
PAYACIQLI	sif.;
PAYALA	f.;
PAYALAMAQ	f.;
PAYALANMAQ	f.;
PAYALAT	f.;
PAYALI	sif.;
PAYALIQ	is.;
PAYAÇƏPƏRİ	is.;
PAYAÜSTÜ	sif.;
PAYBƏND	is.;
PAYCIQ	is.;
PAYCIQARASI	sif.;
PAYCIQDAXİLİ	sif.;
PAYIBƏLLİ	sif.;
PAYIZ	is.;
PAYIZ-QIŞ	is.;
PAYIZAĞZI	is.;
PAYIZBÜLBÜLÜ	is.;
PAYIZGÜLÜ	is.;
PAYIZLIQ	sif.;
PAYLA	f.;
PAYLAMA-TƏHVİLVERMƏ	f.;
PAYLAN	f.;
PAYLANIŞ	is.;
PAYLANMIŞ	f_sif.;
PAYLAT	f.;
PAYLATDIR	f.;
PAYLAYICI	sif.;
PAYLAŞ	f.;
PAYLAŞDIR	f.;
PAYLAŞDIRICI	sif.;
PAYLAŞDIRIL	f.;
PAYMAL	is.;
PAYQOYMA	is.;
PAYTAXT	is.;
PAYÇI	is.;
PAYÇILIQ	is.;
