QIM	is.;
QIMILDA	f.;
QIMILDA(N)MAQ	f.;
QIMILDAN	f.;
QIMILDANMADAN	f.;
QIMILDAT	f.;
QIMILDATMAQ	f.;
QIMILDAYA-QIMILDAYA	f.;
QIMILDAŞ	f.;
QIMILDAŞMAQ	f.;
QIMILTI	is.;
QIMIZ	is.;
QIMIŞ	f.;
QIMIŞDIR	f.;
QIMIŞIQ	is.;
QIMIŞMAQ	f.;
QIMZAN	f.;
QIMZANDIR	f.;
QIMZANDIRMAQ	f.;
QIMZANMAQ	f.;
QIMZAT	f.;
QIMZATMAQ	f.;
