QUDA	is.;
QUDALAŞMAQ	f.;
QUDALIQ	is.;
QUDOK	is.;
QUDRON	is.;
QUDRONLAMAQ	f.;
QUDRONLANMAQ	f.;
QUDRONLANMIŞ	f.;
QUDRONLU	sif.;
QUDUR	f.;
QUDURMAQ	f.;
QUDURMUŞ	f.;sif.;
QUDURMUŞCASINA	zer.;
QUDURT	f.;
QUDURTMAQ	f.;
QUDURĞAN	sif.;
QUDURĞANCA	zer.;
QUDURĞANCASINA	zer.;
QUDURĞANLAŞ	f.;
QUDURĞANLAŞMAQ	f.;
QUDURĞANLIQ	is.;
QUDUZ	sif.;
QUDUZCA	zer.;
QUDUZCASINA	zer.;
QUDUZLAŞ	f.;
QUDUZLAŞDIR	f.;
QUDUZLAŞDIRMAQ	f.;
QUDUZLAŞMAQ	f.;
QUDUZLUQ	is.;
QUDUZOTU	is.;
