SAHMAN	is.;
SAHMANLA	f.;
SAHMANLAMA	f_is.;
SAHMANLAMAQ	f.;
SAHMANLAN	f.;
SAHMANLATDIR	f.;
SAHMANLAŞ	f.;
SAHMANLAŞDIR	f.;
SAHMANLAŞDIRIL	f.;
SAHMANLI	sif.;
SAHMANÇI	is.;
SAHİB	is.;
SAHİBKAR	is.;
SAHİBKARLIQ	is.;
SAHİBLİK	is.;
SAHİBLƏN	f.;
SAHİBLƏNMƏ	f_is.;
SAHİBLƏNMƏK	f.;
SAHİBMƏNSƏB	f.;is.;sif.;
SAHİBNƏFƏS	is.;
SAHİBNƏZƏR	sif.;
SAHİBSİZ	sif.;
SAHİBSİZLİK	is.;
SAHİBƏ	is.;
SAHİL	is.;
SAHİLBOYU	sif.;
SAHİLBƏRKİTMƏ	f.;
SAHİLQORUYAN	is.;
SAHİLSİZ	sif.;
SAHİLSİZLİK	is.;
SAHİLYANI	sif.;
SAHƏ	is.;
SAHƏCİK	is.;
SAHƏDAXİLİ	sif.;
SAHƏKƏNARI	sif.;
SAHƏLƏRARASI	sif.;
