SAÇ	is.;
SAÇ-BIĞ	is.;
SAÇ-BİRÇƏK	top.;
SAÇ-SAQQAL	is.;
SAÇAQ	f.;is.;
SAÇAQ-SAÇAQ	zer.;
SAÇAQLA	f.;
SAÇAQLAMA	f_is.;
SAÇAQLAMAQ	f.;
SAÇAQLAN	f.;
SAÇAQLANMA	f_is.;
SAÇAQLANMAQ	f.;
SAÇAQLI	sif.;
SAÇAQLILIQ	is.;
SAÇAQSIZ	sif.;
SAÇAYIRAN	is.;
SAÇBAĞI	ba.;is.;
SAÇBURAN	is.;f_sif.;
SAÇDIRIL	f.;
SAÇDÜZÜMÜ	is.;
SAÇDÜZƏLDƏN	is.;f_sif.;
SAÇIL	f.;
SAÇILMA	f_is.;
SAÇILMAQ	f.;
SAÇLA	f.;
SAÇLAMA	f_is.;
SAÇLAMAQ	f.;
SAÇLAN	f.;
SAÇLANMA	f_is.;
SAÇLANMAQ	f.;
SAÇLAŞ	f.;
SAÇLAŞMA	f_is.;
SAÇLAŞMAQ	qars.;
SAÇLI	sif.;
SAÇLI-BİRÇƏKLİ	sif.;
SAÇLI-SAQQALLI	sif.;
SAÇLI-SAÇAQLI	sif.;
SAÇLILIQ	is.;
SAÇMA	f_is.;
SAÇMALAMA	f_is.;
SAÇMALAMAQ	f.;
SAÇMAQ	f.;
SAÇQIRAN	is.;
SAÇQIRXAN	is.;
SAÇQURUDAN	is.;
SAÇSIZ	sif.;
SAÇSIZLIQ	is.;
SAÇUZADAN	is.;
SAÇŞƏKİLLİ	sif.;
