SUS	f.;
SUSA	f.;
SUSAT	f.;
SUSAXLAYICI	is.;
SUSDUR	f.;
SUSDURT	f.;
SUSDURUL	f.;
SUSDURULMA	is.;
SUSDURULMAQ	f.;
SUSEVƏN	f_sif.;
SUSEVƏR	sif.;
SUSIZDIRAN	f_sif.;
SUSIÇRADAN	f_sif.;
SUSIÇRADICI	sif.;
SUSMA	is.;
SUSMAQ	f.;
SUSMAZ	sif.;
SUSOYUDAN	f_sif.;
SUSOYUDUCU	sif.;
SUSPENZİYA	is.;
SUSQUN	zer.;sif.;
SUSQUNLAŞ	f.;
SUSQUNLUQ	is.;
SUSTALMA	is.;
SUSTALMAQ	f.;
SUSUZ	sif.;
SUSUZDUR	f.;
SUSUZLA	f.;
SUSUZLAMA	is.;
SUSUZLAMAQ	f.;
SUSUZLAŞ	f.;
SUSUZLAŞDIR	f.;
SUSUZLAŞDIRIL	f.;
SUSUZLUQ	is.;
SUSÜNBÜLÇİÇƏYİ	is.;
SUSÜNBÜLÜ	is.;
SUSÜZƏN	is.;
SUSİÇANI	is.;
SUSİÇOVULU	is.;
SUSƏPƏLƏYƏN	is.;
SUSƏPƏN	is.;
SUSƏRÇƏSİ	is.;
