SÖN	f.;
SÖNDÜR	f.;
SÖNDÜRMƏ	is.;
SÖNDÜRMƏK	f.;
SÖNDÜRT	f.;
SÖNDÜRTMƏ	f.;
SÖNDÜRÜCÜ	sif.;
SÖNDÜRÜL	f.;
SÖNDÜRÜLMƏ	is.;
SÖNDÜRÜLMƏK	f.;
SÖNDÜRÜLMƏZ	sif.;
SÖNMÜŞ	f_sif.;
SÖNMƏ	is.;
SÖNMƏK	f.;
SÖNMƏMİŞ	sif.;
SÖNMƏYƏN	f_sif.;
SÖNMƏZ	sif.;
SÖNMƏZLİK	is.;
SÖNÜK	sif.;zer.;
SÖNÜKLÜK	is.;
SÖNÜKLƏŞ	f.;
SÖNÜKLƏŞMƏ	f.;
