SÜD	is.;
SÜD-QATIQ	is.;
SÜD-ƏPPƏK	is.;
SÜDAYIRAN	sif.;
SÜDAZLIĞI	is.;
SÜDAŞI	is.;
SÜDDAN	is.;
SÜDDAŞ	sif.;
SÜDDAŞIYAN	is.;
SÜDDİŞİ	is.;
SÜDLÜ	sif.;
SÜDLÜAŞ	is.;
SÜDLÜK	is.;
SÜDLÜK-DAMAZLIQ	is.;
SÜDLÜK-ƏTLİK	is.;
SÜDLÜLÜK	is.;
SÜDLÜPLOV	is.;
SÜDLÜSIYIQ	is.;
SÜDLƏN	f.;
SÜDLƏNDİR	f.;
SÜDLƏNDİRMƏ	f.;
SÜDLƏNDİRİL	f.;
SÜDLƏNDİRİLMƏ	f.;
SÜDLƏNMƏ	f.;
SÜDLƏYƏN	is.;
SÜDLƏYƏNKİMİ	zer.;
SÜDLƏYƏNÇİÇƏKLİ	sif.;
SÜDOTU	is.;
SÜDQABI	is.;
SÜDRƏNGLİ	sif.;
SÜDSATAN	is.;
SÜDSAĞAN	is.;
SÜDSOYUDUCU	is.;
SÜDSÜZ	sif.;
SÜDSÜZLÜK	is.;
SÜDTƏMİZLƏYƏN	sif.;
SÜDUR	sif.;
SÜDVARI	sif.;
SÜDVERMƏ	f.;
SÜDVERİMİ	is.;
SÜDVERƏN	sif.;
SÜDXANA	is.;
SÜDYOLU	is.;
SÜDÇÜ	is.;
SÜDÇÜLÜK	is.;
SÜDÇÜLÜK-TƏRƏVƏZÇİLİK	is.;
SÜDÇÜLÜK-ƏTÇİLİK	is.;
SÜDŞİRƏSİ	is.;
SÜDƏCƏR	sif.;
SÜDƏCƏRLİK	is.;
SÜDƏMƏR	sif.;
SÜDƏMƏRLİK	is.;
