SÜLALƏ	is.;
SÜLB	is.;
SÜLB	sif.;
SÜLBLÜK	is.;
SÜLEYMANİ	is.;
SÜLH	is.;
SÜLH-SƏADƏT	is.;
SÜLHMƏRAMLI	sif.;
SÜLHPƏRVƏR	sif.;
SÜLHPƏRVƏRLİK	is.;
SÜLHSEVMƏ	f.;
SÜLHSEVƏN	sif.;
SÜLHSEVƏR	sif.;
SÜLHSEVƏRLİK	is.;
SÜLÜGƏN	is.;
SÜLÜK	f.;is.;sif.;
SÜLƏK	sif.;
SÜLƏN	f.;
SÜLƏNDİR	f.;
SÜLƏNDİRMƏ	f.;
SÜLƏNDİRİL	f.;
SÜLƏNDİRİLMƏ	f.;
SÜLƏNMƏ	is.;
SÜLƏNMƏK	f.;
SÜLƏNƏ-SÜLƏNƏ	zer.;
