TAR	is.;
TAR	is.;
TAR	is.;
TAR	zer.;sif.;
TAR-KAMAN	is.;
TAR-KAMANÇA	is.;
TAR-MAR	sif.;
TAR-QAVAL	is.;
TAR-ZÜLMƏT	sif.;
TARAC	is.;
TARAKAN	is.;
TARAKANKİMİ	sif.;
TARANLA	f.;
TARANLAMAQ	f.;
TARANLAN	f.;
TARANTAS	is.;
TARANTELLA	is.;
TARAP-TARAP	teq.;
TARAP-TURUP	teq.;
TARAP-TURUPLA	zer.;
TARAPPADAN	zer.;
TARAQ-TURUQ	teq.;
TARAQQA	is.;
TARAQQALI	sif.;
TARAQQATARAQ	teq.;
TARAZ	sif.;
TARAZI	is.;
TARAZLA	f.;
TARAZLAMA	is.;
TARAZLAMAQ	f.;
TARAZLAN	f.;
TARAZLANMA	is.;
TARAZLANMAQ	f.;
TARAZLAYICI	sif.;
TARAZLAŞ	f.;
TARAZLAŞDIR	f.;
TARAZLAŞDIRICI	sif.;
TARAZLAŞDIRIL	f.;
TARAZLAŞDIRILMA	is.;
TARAZLAŞDIRILMAQ	f.;
TARAZLAŞDIRMA	is.;
TARAZLAŞDIRMAQ	f.;
TARAZLAŞMA	is.;
TARAZLAŞMAQ	f.;
TARAZLILIQ	is.;
TARAZLIQ	is.;
TARAZSIZ	sif.;
TARAZSIZLIQ	is.;
TARAŞ	is.;
TARAŞLAMA	f_is.;
TARAŞLAMAQ	f.;
TARAŞLI	sif.;
TARCIQ	is.;
TARIM	zer.;
TARIMLA	f.;
TARIMLAMA	is.;
TARIMLAMAQ	f.;
TARIMLAN	f.;
TARIMLAT	f.;
TARIMLAYICI	sif.;
TARIMLAŞ	f.;
TARIMLAŞDIR	f.;
TARIMLIQ	is.;
TARLA	is.;
TARLA-MAĞAZA	is.;
TARLALARARASI	zer.;
TARLALI	sif.;
TARLALIQ	is.;
TARLAN	f.;
TARLANMA	f_is.;
TARLANMAQ	f.;
TARLAOTU	is.;
TARLAQORUYAN	is.;
TARLAQORUYUCU	sif.;
TARLAÇI	is.;
TARLAÇILIQ	is.;
TARLAŞ	f.;
TARLAŞMA	is.;
TARLAŞMAQ	f.;
TARLIQ	is.;
TARP	teqlidi.;
TARPILDA	f.;
TARPILDAT	f.;
TARPILTI	teq.;
TARTAN-PARTAN	zer.;is.;
TARZƏN	is.;
TARZƏNLİK	is.;
TARÇALAN	is.;
TARÇI	is.;
TARÇILIQ	is.;
TARİF	is.;
TARİFLƏŞDİR	f.;
TARİFLƏŞDİRMƏ	is.;
TARİFLƏŞDİRMƏK	f.;
TARİFLƏŞDİRİL	f.;
TARİFLƏŞDİRİLMƏ	is.;
TARİFLƏŞDİRİLMƏK	f.;
TARİFÇİ	is.;
TARİFÇİLİK	is.;
TARİK	is.;
TARİX	is.;
TARİX-DİYARŞÜNASLIQ	is.;
TARİX-ETNOQRAFİYA	is.;
TARİX-FƏLSƏFƏ	is.;
TARİXLİ	sif.;
TARİXNƏVİS	is.;
TARİXNƏVİSLİK	is.;
TARİXSİZ	sif.;
TARİXSİZLİK	is.;
TARİXYAZAN	is.;
TARİXÇİ	is.;
TARİXÇİLİK	is.;
TARİXÇƏ	is.;
TARİXİ	sif.;
TARİXİ-BİBLİOQRAFİK	sif.;
TARİXİ-BƏDİİ	sif.;
TARİXİ-ETNOQRAFİK	sif.;
TARİXİ-FƏLSƏFİ	sif.;
TARİXİ-HİCRİ	is.;
TARİXİ-MÜQAYİSƏLİ	sif.;
TARİXİ-MİLADİ	is.;
TARİXİ-İCTİMAİ	sif.;
TARİXİ-İNQİLABİ	sif.;
TARİXİ-ƏDƏBİ	sif.;
TARİXİLİK	is.;
TARİXİZM	is.;
TARİXŞÜNAS	is.;
TARİXŞÜNASLIQ	is.;
TARİXƏN	sif.;
TARİXƏQƏDƏRKİ	sif.;
