TƏHARƏT	is.;
TƏHDİD	is.;
TƏHDİDAMİZ	sif.;
TƏHDİDEDİCİ	sif.;
TƏHKİM	is.;
TƏHKİMLİ	is.;
TƏHKİMÇİ	is.;
TƏHKİMÇİ	is.;
TƏHKİMÇİLİK	is.;
TƏHKİYƏ	is.;
TƏHKİYƏÇİ	is.;
TƏHLÜKƏ	is.;
TƏHLÜKƏLİ	sif.;
TƏHLÜKƏLİLİK	is.;
TƏHLÜKƏSİZ	sif.;
TƏHLÜKƏSİZLİK	is.;
TƏHLÜKƏSİZLƏŞ	f.;
TƏHLÜKƏSİZLƏŞDİR	f.;
TƏHLÜKƏSİZLƏŞDİRMƏ	f.;
TƏHLÜKƏSİZLƏŞDİRİL	f.;
TƏHLÜKƏSİZLƏŞDİRİLMƏ	f.;
TƏHLÜKƏSİZLƏŞMƏ	f.;
TƏHLİL	is.;
TƏHLİL-TƏDQİQ	is.;
TƏHLİL-TƏNQİD	is.;
TƏHLİLEDİCİ	sif.;
TƏHLİLİ	sif.;
TƏHQİQ	is.;
TƏHQİQAT	is.;
TƏHQİQATÇI	is.;
TƏHQİQATÇILIQ	is.;
TƏHQİR	is.;
TƏHQİRAMİZ	sif.;
TƏHQİRAMİZLİK	is.;
TƏHQİRANƏ	zer;sif.;
TƏHQİREDİCİ	sif.;
TƏHQİREDİCİLİK	is.;
TƏHQİRLİ	sif.;
TƏHR	is.;qo.;
TƏHRİF	is.;
TƏHRİFEDİCİ	sif.;
TƏHRİFEDİLMİŞ	f_sif.;
TƏHRİFÇİ	is.;
TƏHRİFÇİLİK	is.;
TƏHRİK	is.;
TƏHRİKEDİCİ	sif.;
TƏHRİKEDİCİLİK	is.;
TƏHRİKÇİ	is.;
TƏHRİKÇİLİK	is.;
TƏHRİR	is.;
TƏHRİRİ	sif.;zer.;
TƏHSİL	is.;
TƏHSİLCƏ	zer.;
TƏHSİLLİ	sif.;
TƏHSİLLİK	is.;
TƏHSİLLƏN	f.;
TƏHSİLLƏNDİR	f.;
TƏHSİLSİZ	sif.;
TƏHSİLSİZLİK	is.;
TƏHSİN	f.;is.;
TƏHSİNEDİCİ	sif.;
TƏHT	is.;
TƏHTƏLHESAB	f.;is.;sif.;
TƏHTƏLŞÜUR	is.;
TƏHVİL	is.;
TƏHVİL-TƏSLİM	is.;
TƏHVİLVERMƏ	f.;
TƏHVİLVERƏN	is.;
TƏHVİLÇİ	is.;
TƏHƏMMÜL	is.;
TƏHƏR	is.;qo.;
TƏHƏR-TÖHÜR	is.;
TƏHƏRBƏTƏHƏR	zer.;
TƏHƏRLİ	sif.;
TƏHƏRSİZ	sif.;
TƏHƏSSÜR	is.;
TƏHƏVVÜL	is.;
TƏHƏYYÜR	is.;
