TƏMAS	is.;
TƏMAYÜL	is.;
TƏMAYÜLLÜ	sif.;
TƏMAYÜLÇÜ	is.;
TƏMAYÜLÇÜLÜK	is.;
TƏMHİD	is.;
TƏMKİN	is.;
TƏMKİNLİ	sif.;zer.;
TƏMKİNLİK	is.;
TƏMKİNLİLİK	is.;
TƏMKİNLƏ	zer.;
TƏMRİN	is.;
TƏMSİL	is.;
TƏMSİLAT	is.;
TƏMSİLEDƏN	is.;
TƏMSİLÇİ	is.;
TƏMTƏRAQ	is.;
TƏMTƏRAQLI	sif.;
TƏMTƏRAQLILIQ	is.;
TƏMTƏRAQSIZ	sif.;
TƏMTƏRAQSIZLIQ	is.;
TƏMİM	is.;
TƏMİMNAMƏ	f.;
TƏMİN	is.;
TƏMİNAT	is.;
TƏMİNATLI	sif.;
TƏMİNATLILIQ	is.;
TƏMİNATSIZ	sif.;
TƏMİNATSIZLIQ	is.;
TƏMİNATÇI	is.;
TƏMİNEDİCİ	sif.;
TƏMİNEDİCİLİK	is.;
TƏMİNETMƏ	f.;
TƏMİR	is.;
TƏMİR-MEXANİZM	is.;
TƏMİRARASI	sif.;
TƏMİRAT	is.;top.;
TƏMİRXANA	is.;
TƏMİRÇİ	is.;
TƏMİRÇİ-ÇİLİNGƏR	is.;
TƏMİRÇİLİK	is.;
TƏMİRƏYARARLILIQ	is.;
TƏMİZ	sif.;
TƏMİZCİNSLİ	sif.;
TƏMİZCƏ	sif.;
TƏMİZKAR	sif.;
TƏMİZKARCA	zer.;
TƏMİZKARCASINA	zer.;
TƏMİZKARLIQ	is.;
TƏMİZLİK	is.;
TƏMİZLƏ	f.;
TƏMİZLƏMƏ	is.;
TƏMİZLƏMƏK	f.;
TƏMİZLƏN	f.;
TƏMİZLƏNMƏ	is.;
TƏMİZLƏNMƏK	f.;
TƏMİZLƏT	f.;
TƏMİZLƏTMƏ	f.;
TƏMİZLƏYİCİ	is.;sif.;
TƏMİZQANLI	sif.;
TƏMİZQANLILIQ	is.;
TƏMİZQƏLBLİ	sif.;
TƏMİZQƏLBLİLİK	is.;
TƏMİZÜRƏKLİ	sif.;
TƏMİZÜRƏKLİLİK	is.;
TƏMƏL	is.;
TƏMƏLLİ	sif.;
TƏMƏLLİLİK	is.;
TƏMƏLLƏN	f.;
TƏMƏLLƏNMƏ	f.;
TƏMƏLSİZ	sif.;
TƏMƏLSİZLİK	is.;
TƏMƏLÇİ	is.;
TƏMƏLÇİLİK	is.;
TƏMƏNNA	ed.;is.;
TƏMƏNNALI	sif.;
TƏMƏNNALILIQ	is.;
TƏMƏNNASIZ	sif.;
TƏMƏNNASIZLIQ	is.;
TƏMƏNNAÇI	is.;
TƏMƏNNƏŞ	f.;
TƏMƏNNƏŞMƏ	f.;
TƏMƏRKÜZ	is.;
TƏMƏRKÜZLƏŞ	f.;
TƏMƏRKÜZLƏŞDİR	f.;
TƏMƏRKÜZLƏŞDİRMƏ	is.;
TƏMƏRKÜZLƏŞDİRMƏK	f.;
TƏMƏRKÜZLƏŞDİRİL	f.;
TƏMƏRKÜZLƏŞDİRİLMƏ	is.;
TƏMƏRKÜZLƏŞDİRİLMƏK	f.;
TƏMƏRKÜZLƏŞMƏ	is.;
TƏMƏRKÜZLƏŞMƏK	f.;
TƏMƏSSÜK	is.;
