TƏR	is.;
TƏR	sif.;
TƏR-TƏZƏ	sif.;
TƏR-TƏZƏCƏ	sif.;
TƏR-TƏZƏLİK	is.;
TƏRANƏ	is.;
TƏRANƏ-TƏRƏNNÜM	is.;
TƏRAVƏT	is.;
TƏRAVƏTLİ	sif.;zer.;
TƏRAVƏTLİLİK	is.;
TƏRAVƏTLƏN	f.;
TƏRAVƏTLƏNDİR	f.;
TƏRAVƏTLƏNDİRMƏ	f.;
TƏRAVƏTLƏNMƏ	is.;
TƏRAVƏTLƏNMƏK	f.;
TƏRBİYƏ	is.;
TƏRBİYƏ-TƏHSİL	is.;
TƏRBİYƏ-Ə	is.;
TƏRBİYƏLİ	sif.;
TƏRBİYƏLİLİK	is.;
TƏRBİYƏLƏN	f.;
TƏRBİYƏLƏNDİR	f.;
TƏRBİYƏLƏNDİRMƏ	is.;
TƏRBİYƏLƏNDİRMƏK	f.;
TƏRBİYƏLƏNDİRİCİ	sif.;
TƏRBİYƏLƏNDİRİLMƏ	is.;
TƏRBİYƏLƏNDİRİLMƏK	f.;
TƏRBİYƏLƏNMƏ	is.;
TƏRBİYƏLƏNMƏK	f.;
TƏRBİYƏLƏT	f.;
TƏRBİYƏLƏTMƏ	f.;
TƏRBİYƏSİZ	sif.;
TƏRBİYƏSİZLİK	is.;
TƏRBİYƏVERİCİ	sif.;
TƏRBİYƏVİ	sif.;
TƏRBİYƏXANA	is.;
TƏRBİYƏÇİ	is.;
TƏRBİYƏÇİLİK	is.;
TƏRCÜMAN	is.;
TƏRCÜMANLIQ	is.;
TƏRCÜMEYİ-HAL	is.;
TƏRCÜMƏ	is.;
TƏRCÜMƏSİZ	sif.;
TƏRCÜMƏÇİ	is.;
TƏRCÜMƏÇİLİK	is.;
TƏRCİBƏND	is.;
TƏRCİH	is.;
TƏRCİHƏN	zer.;
TƏRGİT	f.;
TƏRGİTDİR	f.;
TƏRGİTDİRMƏ	is.;
TƏRGİTDİRMƏK	f.;
TƏRGİTMƏ	is.;
TƏRGİTMƏK	f.;
TƏRGƏTİRİCİ	sif.;
TƏRHALVA	is.;
TƏRK	is.;
TƏRK	is.;
TƏRK	is.;
TƏRK-SİLAH	is.;
TƏRKALTI	is.;
TƏRKLƏŞ	f.;
TƏRKLƏŞDİR	f.;
TƏRKLƏŞDİRMƏ	f.;
TƏRKLƏŞMƏ	f_is.;
TƏRKLƏŞMƏK	f.;
TƏRKÖYNƏK	f.;is.;
TƏRKİ-ADƏT	sif.;
TƏRKİ-DÜNYA	is.;
TƏRKİ-DÜNYALIQ	is.;
TƏRKİ-VƏTƏN	is.;
TƏRKİ-ƏDƏB	is.;
TƏRKİ-ƏDƏBLİK	is.;
TƏRKİB	is.;
TƏRKİBBƏND	is.;
TƏRKİBLİ	sif.;
TƏRLAN	is.;
TƏRLİ	sif.;
TƏRLİ-TƏRLİ	zer.;
TƏRLİK	is.;
TƏRLƏ	f.;
TƏRLƏDİCİ	sif.;
TƏRLƏDİCİLİK	is.;
TƏRLƏMƏ	is.;
TƏRLƏMƏK	f.;
TƏRLƏT	f.;
TƏRLƏTMƏ	is.;
TƏRLƏTMƏK	f.;
TƏROTU	is.;
TƏRPƏDİL	sif.;
TƏRPƏDİLMƏ	is.;
TƏRPƏDİLMƏK	f.;
TƏRPƏN	f.;
TƏRPƏNMƏ	is.;
TƏRPƏNMƏK	f.;
TƏRPƏNMƏZ	f.;
TƏRPƏNMƏZLİK	is.;
TƏRPƏNTİ	is.;
TƏRPƏNİŞ	is.;
TƏRPƏNİŞMƏ	f_is.;
TƏRPƏNİŞMƏK	f.;
TƏRPƏT	f.;
TƏRPƏTMƏ	is.;
TƏRPƏTMƏDƏN	f_sif.;
TƏRPƏTMƏK	f.;
TƏRPƏŞ	f.;
TƏRPƏŞDİR	f.;
TƏRPƏŞDİRMƏ	f.;
TƏRPƏŞMƏ	is.;
TƏRPƏŞMƏK	f.;
TƏRS	sif.;zer.;
TƏRS-AVAND	sif.;
TƏRSA	is.;
TƏRSABEÇƏ	is.;
TƏRSANƏ	is.;
TƏRSANƏÇİ	is.;
TƏRSANƏÇİ-MEXANİZATOR	is.;
TƏRSLİK	is.;
TƏRSLƏŞ	f.;
TƏRSLƏŞDİR	f.;
TƏRSLƏŞDİRMƏ	f.;
TƏRSLƏŞMƏ	f.;
TƏRSÇALOVLU	sif.;
TƏRSİM	is.;
TƏRSİNƏ	zer.;
TƏRSƏ	sif.;zer.;
TƏRSƏSİNƏ	zer.;
TƏRTİB	is.;
TƏRTİBAT	is.;
TƏRTİBATÇI	is.;
TƏRTİBATÇILIQ	is.;
TƏRTİBLİ	sif.;
TƏRTİBLİLİK	is.;
TƏRTİBSİZ	sif.;
TƏRTİBSİZLİK	is.;
TƏRTİBÇİ	is.;
TƏRTİBÇİLİK	is.;
TƏRTƏLƏSİK	zer.;
TƏRTƏMİZ	zer.;sif.;
TƏRTƏMİZLİK	is.;
TƏRXAN	is.;
TƏRXANLIQ	is.;
TƏRXUN	is.;
TƏRXİS	is.;
TƏRXİSETMƏ	f.;
TƏRZ	is.;
TƏRZİ-HƏRƏKƏT	is.;
TƏRZİ-TƏFƏKKÜR	is.;
TƏRZİ-TƏLƏFFÜZ	is.;
TƏRZİ-İFADƏ	is.;
TƏRİF	is.;
TƏRİFLİ	sif.;
TƏRİFLİLİK	is.;
TƏRİFLƏ	f.;
TƏRİFLƏMƏ	is.;
TƏRİFLƏMƏK	f.;
TƏRİFLƏN	f.;
TƏRİFLƏNMƏ	is.;
TƏRİFLƏNMƏK	f.;
TƏRİFLƏT	f.;
TƏRİFLƏTMƏ	f.;
TƏRİFNAMƏ	ed.;is.;
TƏRİFSİZ	sif.;
TƏRİFSİZLİK	is.;
TƏRİFƏGƏLMƏZ	sif.;
TƏRİFƏGƏLMƏZLİK	is.;
TƏRİFƏLAYİQ	sif.;
TƏRİFƏLAYİQLİK	is.;
TƏRİQ	is.;
TƏRİQƏT	is.;
TƏRİQƏTÇİ	is.;
TƏRİQƏTÇİLİK	is.;
TƏRƏ	is.;
TƏRƏCƏ	is.;
TƏRƏDDÜD	is.;
TƏRƏDDÜDLÜ	sif.;
TƏRƏDDÜDLƏ	zer.;
TƏRƏDDÜDSÜZ	zer.;
TƏRƏDDÜDSÜZLÜK	is.;
TƏRƏDDÜM	is.;
TƏRƏF	is.;qo.;
TƏRƏF-MÜQABİL	is.;
TƏRƏF-MÜQABİLLİK	is.;
TƏRƏFBAZ	sif.;
TƏRƏFBAZLIQ	is.;
TƏRƏFDAR	is.;
TƏRƏFDARLIQ	is.;
TƏRƏFDAŞ	is.;
TƏRƏFDAŞLIQ	is.;
TƏRƏFGİR	is.;
TƏRƏFGİRLİK	is.;
TƏRƏFKEŞ	sif.;
TƏRƏFKEŞLİK	is.;
TƏRƏFLİ	sif.;
TƏRƏFSAXLAYAN	sif.;
TƏRƏHHÜM	is.;
TƏRƏHHÜMLÜ	sif.;
TƏRƏHHÜMLÜLÜK	is.;
TƏRƏHHÜMSÜZ	sif.;
TƏRƏHHÜMSÜZLÜK	is.;
TƏRƏK	is.;
TƏRƏKƏ	is.;
TƏRƏKƏMƏ	is.;
TƏRƏKƏMƏ-KÖÇƏRİ	is.;
TƏRƏKƏMƏÇİLİK	is.;
TƏRƏNNÜM	is.;
TƏRƏNNÜMÇÜ	is.;
TƏRƏOTU	is.;
TƏRƏQQİ	is.;
TƏRƏQQİ-İNKİŞAF	is.;
TƏRƏQQİPƏRVƏR	sif.;
TƏRƏQQİPƏRVƏRLİK	is.;
TƏRƏQQİYYAT	is.;
TƏRƏSSÜD	is.;
TƏRƏVƏZ	is.;
TƏRƏVƏZ-BOSTAN	is.;
TƏRƏVƏZDOĞRAYAN	is.;
TƏRƏVƏZLİK	is.;
TƏRƏVƏZQURUDAN	is.;
TƏRƏVƏZSATAN	is.;
TƏRƏVƏZYIĞAN	is.;
TƏRƏVƏZÇİ	is.;
TƏRƏVƏZÇİLİK	is.;
TƏRƏZİ	is.;
TƏRƏZİPULU	is.;
TƏRƏZİÇİ	is.;
TƏRƏZİÇİLİK	is.;
TƏRƏÇİÇƏKLİ	sif.;
TƏRƏÇİÇƏKLİLƏR	is.;
