VUR	f.;
VUR-TUT	ba.;
VUR-ÇATLASIN	is.;
VURAN	ed.;is.;
VURAN	f.;
VURAĞAN	sif.;
VURAĞANLIQ	is.;
VURDUR	f.;
VURDURMAQ	f.;
VURHARAY	is.;
VURHAVUR	zer.;is.;
VURMA	f_is.;
VURMA-BÖLMƏ	is.;
VURMA-DÖNMƏ	is.;
VURMA-FIRLANMA	is.;
VURMA-TOPLAMA	is.;
VURMA-ÇIXMA	is.;
VURMAQ	zer.;f.;t-siz.;
VURNUX	f.;
VURNUXMAQ	f.;
VURUB-YIX	f.;
VURUB-YIXAN	sif.;
VURUB-YIXMA	is.;
VURUCU	sif.;
VURUL	f.;
VURULAN	ed.;is.;
VURULMAQ	f.;
VURULMAQ	f.;
VURULMUŞ	f_sif.;
VURUM	is.;
VURUQ	is.;
VURUŞ	is.;
VURUŞA-VURUŞA	zer.;
VURUŞAN	f.;
VURUŞDUR	f.;
VURUŞDURMAQ	f.;
VURUŞDURUL	f.;
VURUŞMAQ	f.;
VURUŞQAN	sif.;
VURÇATLASIN	is.;
VURĞU	is.;
VURĞU	is.;
VURĞULA	f.;
VURĞULAN	f.;
VURĞULU	sif.;
VURĞUN	sif.;
VURĞUNCASINA	zer.;
VURĞUNLAN	f.;
VURĞUNŞÜNAS	is.;
VURĞUNŞÜNASLIQ	is.;
VURĞUQABAĞI	sif.;
VURĞUSUZ	sif.;
VURĞUSUZLUQ	is.;
