VƏTƏGƏ	is.;
VƏTƏGƏÇİ	is.;
VƏTƏN	is.;
VƏTƏNDAŞ	is.;
VƏTƏNDAŞLIQ	is.;
VƏTƏNDAŞSIZ	sif.;
VƏTƏNDAŞSIZLIQ	is.;
VƏTƏNLİ	sif.;
VƏTƏNLƏŞDİR	f.;
VƏTƏNLƏŞDİRMƏ	f.;
VƏTƏNPƏRVƏR	sif.;
VƏTƏNPƏRVƏRANƏ	sif.;zer.;
VƏTƏNPƏRVƏRCƏSİNƏ	sif.;zer.;
VƏTƏNPƏRVƏRLİK	is.;
VƏTƏNPƏRƏST	sif.;
VƏTƏNPƏRƏSTLİK	is.;
VƏTƏNSEVƏR	sif.;
VƏTƏNSEVƏRLİK	is.;
VƏTƏNSİZ	sif.;
VƏTƏNSİZLİK	is.;
VƏTƏNÇİ	is.;
VƏTƏNÇİLİK	is.;
VƏTƏR	is.;
