YAY	f.;
YAY	is.;
YAY-OX	is.;
YAY-QIŞ	zer.;
YAYBAŞI	zer.;
YAYCI	is.;
YAYCIQ	is.;
YAYDAYAŞIL	sif.;
YAYDIR	f.;
YAYDIRMAQ	f.;
YAYDIRT	f.;
YAYDIRTMAQ	f.;
YAYICI	sif.;
YAYICI-SIĞALLAYICI	sif.;
YAYIL	f.;
YAYILAN	f_sif.;
YAYILIŞ	is.;
YAYILMAQ	f.;
YAYILMIŞ	is.;
YAYIM	is.;
YAYIMLAN	f.;
YAYINBALIĞI	is.;
YAYINDIR	f.;
YAYINDIRICI	sif.;
YAYINDIRIL	f.;
YAYINDIRMAQ	f.;
YAYINIQ	sif.;
YAYINLA	f.;
YAYINLAN	f.;
YAYINMAQ	f.;
YAYIQ	sif.;
YAYIQLIQ	is.;
YAYIŞ	f.;
YAYIŞMAQ	f.;
YAYLA	is.;
YAYLALIQ	is.;
YAYLAMAQ	f.;
YAYLAMAQ	f.;
YAYLAN	f.;
YAYLANAN	sif.;
YAYLANDIR	f.;
YAYLANMAQ	f.;
YAYLAQ	is.;
YAYLAQLA	f.;
YAYLAQLAMAQ	f.;
YAYLAQLAN	f.;
YAYLAQLANMAQ	f.;
YAYLAQLIQ	is.;
YAYLAQÇI	is.;
YAYLAT	f.;
YAYLATMAQ	icb.;
YAYLI	sif.;
YAYLI-OPTİK	sif.;
YAYLI-QIŞLI	zer.;
YAYLIM	is.;
YAYLIM	is.;
YAYLIMI	is.;
YAYLIMI	sif.;
YAYLIMLA	f.;
YAYLIMLAMAQ	f.;
YAYLIMLAMAQ	f.;
YAYLIMLAT	f.;
YAYLIMLATMAQ	f.;
YAYLIMLATMAQ	f.;
YAYLIQ	is.;
YAYLIQ	sif.;
YAYMALA	f.;
YAYMALIQ	sif.;
YAYMAQ	f.;
YAYMAÇI	is.;
YAYMAÇILIQ	is.;
YAYQI	is.;
YAYTİPLİ	sif.;
YAYVARI	sif.;
YAYXA	f.;
YAYXALA	f.;
YAYXAMAQ	f.;
YAYXAN	f.;
YAYXANA-YAYXANA	zer.;
YAYXANMAQ	f.;
YAYXIN	f.;
YAYXINMAQ	f.;
YAYÇI(LAR)	is.;
YAYĞIN	sif.;
YAYĞINLAŞ	f.;
YAYĞINLAŞDIR	f.;
YAYĞINLAŞDIRIL	f.;
YAYĞINLAŞDIRILMAQ	f.;
YAYĞINLAŞDIRMAQ	f.;
YAYĞINLAŞMAQ	f.;
YAYĞINLIQ	is.;
