YIR-YIĞIŞ	is.;
YIRT	f.;
YIRTDIR	f.;
YIRTDIRMAQ	f.;
YIRTIB-DAĞIT	f.;
YIRTICI	sif.;
YIRTICICASINA	zer.;
YIRTICILAŞ	f.;
YIRTICILAŞMAQ	f.;
YIRTICILIQ	is.;
YIRTIL	f.;
YIRTILMAQ	f.;
YIRTIQ	is.;
YIRTIQ	sif.;
YIRTIQ-DEŞİK	is.;
YIRTIQ-YAMAQ	is.;
YIRTIQ-YAMAQLI	sif.;
YIRTIQ-YIRTIQ	sif.;
YIRTIQLIQ	is.;
YIRTMAQ	f.;
YIRĞALA	f.;
YIRĞALAMAQ	f.;
YIRĞALAN	f.;
YIRĞALANACAQ	is.;
YIRĞALANAN	f_sif.;
YIRĞALANDIR	f.;
YIRĞALANDIRMAQ	f.;
YIRĞALANMAQ	f.;zer.;
YIRĞALAT	f.;
YIRĞALATMAQ	f.;
YIRĞALAŞ	f.;
YIRĞALAŞMAQ	f.;
YIRĞANMAQ	f.;
