YOR	f.;
YOR-YOXSUL	is.;
YOR-YOXSULLUQ	is.;
YORDAM	is.;
YORDAMLI	sif.;
YORMAQ	f.;
YORMAQ	f.;
YORNUQ	sif.;zer.;
YORT	sif.;
YORTAVLAMAQ	f.;
YORTDURMAQ	f.;
YORTMA	si
YORTMAQ	f.;zer.;
YORUB-YORT	f.;
YORUCU	sif.;
YORUCULUQ	is.;
YORUL	f.;
YORULMADAN	f_sif.;
YORULMAQ	f.;
YORULMAZ	sif.;
YORULMAZLIQ	is.;
YORĞA	is.;sif.;
YORĞALAMAQ	f.;
YORĞALATMAQ	f.;
YORĞALIQ	is.;
YORĞAN	is.;
YORĞAN-DÖŞƏK	is.;
YORĞANALTI	sif.;
YORĞANAĞI	is.;
YORĞANAĞILIQ	is.;
YORĞANIQALIN	sif.;
YORĞANLIQ	is.;sif.;
YORĞANSIRIYAN	is.;
YORĞANSIZ	sif.;
YORĞANTİKƏN	is.;
YORĞANÇA	is.;
YORĞANÇI	is.;
YORĞANÜZÜ	is.;
YORĞANÜZÜLÜK	is.;sif.;
YORĞATOYUQ	is.;
YORĞUN	sif.;zer.;
YORĞUN-ARĞIN	sif.;
YORĞUN-YORĞUN	zer.;
YORĞUN-ÜZGÜN	sif.;
YORĞUNCA	zer.;
YORĞUNCASINA	zer.;
YORĞUNLAMAQ	f.;
YORĞUNLAŞ	f.;
YORĞUNLAŞMAQ	f.;
YORĞUNLUQ	is.;
