YUVA	is.;
YUVAAÇAN	is.;
YUVACIQ	is.;
YUVACIQOTU	is.;
YUVALAMAQ	f.;
YUVALANMAQ	f.;
YUVALI	sif.;
YUVALIQ	is.;
YUVAOTU	is.;
YUVAQ	is.;
YUVAQLAR	is.;
YUVAQLIQ	is.;
YUVAQURMA	is.;
YUVARLA	f.;
YUVARLADIL	f.;
YUVARLAMAQ	f.;
YUVARLAN	f.;
YUVARLANMAQ	f.;
YUVARLAQ	sif.;
YUVARLAQAĞIZ	sif.;
YUVARLAQLA	f.;
YUVARLAQLAMAQ	f.;
YUVARLAQLANDIR	f.;
YUVARLAQLAŞDIR	f.;
YUVARLAQLI	sif.;
YUVARLAQLIQ	is.;
YUVARLAT	f.;
YUVARLATMAQ	f.;
YUVASIZ	sif.;
YUVAVARI	sif.;
YUVAÜSTÜ	sif.;
YUVENİL	is.;
