ÇIĞ	is.;
ÇIĞAN-BIĞAN	is.;
ÇIĞIR	f.;
ÇIĞIR-BAĞIR	is.;
ÇIĞIR-BAĞIRTI	is.;
ÇIĞIR-BAĞIRÇI	is.;
ÇIĞIR-BAĞIRÇILIQ	is.;
ÇIĞIRDA-ÇIĞIRDA	zer.;
ÇIĞIRIQ	is.;
ÇIĞIRIŞ	is.;
ÇIĞIRIŞMA	f_is.;
ÇIĞIRIŞMAQ	f.;
ÇIĞIRMAQ	f.;
ÇIĞIRT	f.;
ÇIĞIRTI	is.;
ÇIĞIRTI-BAĞIRTI	is.;
ÇIĞIRTILI	sif.;
ÇIĞIRTMA	is.;
ÇIĞIRTMA	is.;
ÇIĞIRTMALI	sif.;
ÇIĞIRTMALIQ	sif.;
ÇIĞIRTMAQ	f.;
ÇIĞIRĞAN	sif.;
ÇIĞIRĞANLIQ	is.;
ÇIĞLIQ	is.;
ÇIĞNA	f.;
ÇIĞNAMAQ	f.;
ÇIĞNAMAQ	f.;
