ÇOX	sif.;zer.;
ÇOX-AZ	zer.;
ÇOX-ÇOX	sif.;zer.;
ÇOXADAMLI	sif.;
ÇOXADAMLIQ	is.;
ÇOXADLI	sif.;
ÇOXADLILIQ	is.;
ÇOXAL	f.;
ÇOXALDICI	sif.;
ÇOXALDIL	f.;
ÇOXALDILMAQ	f.;
ÇOXALLAHLI	sif.;
ÇOXALLAHLILIQ	is.;
ÇOXALMAQ	f.;
ÇOXALOVLU	sif.;
ÇOXALT	f.;
ÇOXALTMAQ	f.;
ÇOXALƏTLİ	sif.;
ÇOXAMİLLİ	sif.;
ÇOXAMİLLİLİK	is.;
ÇOXANLAMLI	sif.;
ÇOXAQREQATLI	sif.;
ÇOXARVADLI	sif.;
ÇOXARVADLILIQ	is.;
ÇOXASPEKTLİ	sif.;
ÇOXATIMLI	sif.;
ÇOXATLI	sif.;
ÇOXATOMLU	sif.;
ÇOXAXINLI	sif.;
ÇOXAYAQLI	sif.;
ÇOXAYAQLI(-LAR)	is.;
ÇOXAYAQLILAR	is.;
ÇOXAĞIZLI	sif.;
ÇOXAŞIRIMLI	sif.;
ÇOXBARMAQLI	sif.;
ÇOXBARMAQLIQ	is.;
ÇOXBAŞLI	sif.;
ÇOXBLOKLU	sif.;
ÇOXBORULU	sif.;
ÇOXBOĞAZLI	sif.;
ÇOXBRİQADALI	sif.;
ÇOXBUCAQLI	is.;sif.;
ÇOXBUDAQLI	sif.;
ÇOXBUĞUMLU	sif.;
ÇOXBÖLGÜLÜ	sif.;
ÇOXBÖLMƏLİ	sif.;
ÇOXBÖLÜMLÜ	sif.;
ÇOXBİLMİŞ	sif.;
ÇOXBİLMİŞLİK	is.;
ÇOXBİLƏN	is.;sif.;
ÇOXBİÇİMLİ	sif.;
ÇOXBƏNDLİ	sif.;
ÇOXCA	sif.;zer.;
ÇOXCİLDLİ	sif.;
ÇOXCİLDLİK	is.;
ÇOXCİNSLİ	sif.;
ÇOXCİNSLİLİK	is.;
ÇOXCƏHƏTLİ	sif.;
ÇOXCƏHƏTLİLİK	is.;
ÇOXCƏRGƏLİ	sif.;
ÇOXCƏRGƏLİLİK	is.;
ÇOXDALĞALI	sif.;
ÇOXDAMARLI	sif.;
ÇOXDAN	zer.;
ÇOXDANIŞAN	sif.;
ÇOXDANKI	sif.;
ÇOXDAVAMLI	sif.;
ÇOXDAVAMLILIQ	is.;
ÇOXDAİRƏLİ	sif.;
ÇOXDEBİTLİ	sif.;
ÇOXDÖLLÜ	sif.;
ÇOXDÖVRİYYƏLİ	sif.;
ÇOXDÖVRƏLİ	sif.;
ÇOXDİBLİ	sif.;
ÇOXDİLLİ	sif.;
ÇOXDİLLİLİK	is.;
ÇOXDİRƏKLİ	sif.;
ÇOXDİSKLİ	sif.;
ÇOXDİŞCİKLİ	sif.;
ÇOXDİŞLİ	sif.;
ÇOXDƏFƏLİ	sif.;
ÇOXDƏRƏCƏLİ	sif.;
ÇOXDƏRƏCƏLİLİK	is.;
ÇOXDƏYİŞKƏN	sif.;
ÇOXDƏZGAHLI	sif.;
ÇOXDƏZGAHÇI	sif.;
ÇOXDƏZGAHÇILIQ	is.;
ÇOXEKRANLI	sif.;
ÇOXELEKTRODLU	sif.;
ÇOXELEMENTLİ	sif.;
ÇOXEVLİ	sif.;
ÇOXFAKTORLU	sif.;
ÇOXFAZALI	sif.;
ÇOXFAZLI	sif.;
ÇOXFUNKSİYALI	sif.;
ÇOXFİQURLU	sif.;
ÇOXFƏZALI	sif.;
ÇOXGEDİŞLİ	sif.;
ÇOXGÜCLÜ	sif.;
ÇOXGÜLƏN	is.;
ÇOXGÜNLÜ	sif.;
ÇOXGÜNLÜK	is.;
ÇOXHAKİMİYYƏTLİLİK	is.;
ÇOXHASİLATLI	sif.;
ÇOXHECALI	sif.;
ÇOXHECALILIQ	is.;
ÇOXHÜCEYRƏLİ	sif.;
ÇOXHİSSƏLİ	sif.;
ÇOXHƏCMLİ	sif.;
ÇOXHƏDLİ	sif.;
ÇOXHƏDLİLİK	is.;
ÇOXHƏRƏKƏTLİ	sif.;
ÇOXJANRLI	sif.;
ÇOXJANRLILIQ	is.;
ÇOXKAMERALI	sif.;
ÇOXKANALLI	sif.;
ÇOXKATEQORİYALI	sif.;
ÇOXKOMPONENTLİ	sif.;
ÇOXKONTAKTLI	sif.;
ÇOXKORPUSLU	sif.;
ÇOXKİLOMETRLİK	is.;
ÇOXLAMPALI	sif.;
ÇOXLARI	is.;
ÇOXLAYLI	sif.;
ÇOXLAŞ	f.;
ÇOXLAŞMAQ	f.;
ÇOXLU	sif.;
ÇOXLUCA	sif.;zer.;
ÇOXLUQ	is.;
ÇOXLİNZALI	sif.;
ÇOXLƏLƏKLİ	sif.;
ÇOXLƏPƏLİ	sif.;
ÇOXMANDATLI	sif.;
ÇOXMAZĞALLI	sif.;
ÇOXMAŞINLI	sif.;
ÇOXMEMARLILIQ	is.;
ÇOXMEYVƏLİ	sif.;
ÇOXMOTORLU	sif.;
ÇOXMÖVQELİ	sif.;
ÇOXMÖVZULU	sif.;
ÇOXMÖVZULULUQ	is.;
ÇOXMÜDDƏTLİ	sif.;
ÇOXMÜHƏRRİKLİ	sif.;
ÇOXMİLLƏTLİ	sif.;
ÇOXMİLYARDLI	sif.;
ÇOXMİLYARDLIQ	is.;
ÇOXMİLYONLU	sif.;
ÇOXMİLYONLUQ	is.;
ÇOXMİNLİ	sif.;
ÇOXMİNLİK	is.;
ÇOXMƏCHULLU	sif.;
ÇOXMƏKANLI	sif.;
ÇOXMƏKİKLİ	sif.;
ÇOXMƏNALI	sif.;
ÇOXMƏNALILIQ	is.;
ÇOXMƏNZİLLİ	sif.;
ÇOXMƏQSƏDLİ	sif.;
ÇOXMƏRKƏZLİ	sif.;
ÇOXMƏRTƏBƏ	is.;
ÇOXMƏRTƏBƏ(Lİ)	sif.;
ÇOXMƏRTƏBƏLİ	sif.;
ÇOXMƏTLƏBLİLİK	is.;
ÇOXNÖQTƏLİ	sif.;
ÇOXNÖVBƏLİ	sif.;
ÇOXNÖVBƏLİLİK	is.;
ÇOXNÖVLÜ	sif.;
ÇOXNÖVLÜLÜK	is.;
ÇOXNÖVÇÜ	sif.;
ÇOXNÖVÇÜLÜK	is.;
ÇOXNÜVƏLİ	sif.;
ÇOXNİGAHLILIQ	is.;
ÇOXOBYEKTLİ	sif.;
ÇOXOBYEKTİVLİ	sif.;
ÇOXOTAQLI	sif.;
ÇOXOXLU	sif.;
ÇOXPARTİYALI	sif.;
ÇOXPARTİYALILIQ	is.;
ÇOXPERSONAJLI	sif.;
ÇOXPEŞƏLİ	sif.;
ÇOXPEŞƏÇİLİK	is.;
ÇOXPLANLI	sif.;
ÇOXPLANLILIQ	is.;
ÇOXPROBLEMLİ	sif.;
ÇOXPROBLEMLİLİK	is.;
ÇOXPROFİLLİ	sif.;
ÇOXPİLLƏLİ	sif.;
ÇOXPƏNCƏRƏLİ	sif.;
ÇOXQANADLI	sif.;
ÇOXQANADLILAR	is.;
ÇOXQARINCIQLI	sif.;
ÇOXQARINCIQLILAR	is.;
ÇOXQATLI	sif.;
ÇOXQILLI	sif.;
ÇOXQOLLU	sif.;
ÇOXQURŞAQLI	sif.;
ÇOXQÜTBLÜ	sif.;
ÇOXQİYMƏTLİ	sif.;
ÇOXQİYMƏTLİLİK	is.;
ÇOXRABİTƏLİ	sif.;
ÇOXRƏNGLİ	sif.;
ÇOXRƏNGLİLİK	is.;
ÇOXRƏQƏMLİ	sif.;
ÇOXSAATLI	sif.;
ÇOXSAHƏLİ	sif.;
ÇOXSAHƏLİLİK	is.;
ÇOXSAPLI	sif.;
ÇOXSAYLI	sif.;
ÇOXSAYĞACLI	sif.;
ÇOXSEKSİYALI	sif.;
ÇOXSERİYALI	sif.;
ÇOXSIRALI	sif.;
ÇOXSTANDARTLI	sif.;
ÇOXSURƏTLİ	sif.;
ÇOXSÖZLÜ	sif.;
ÇOXSÜMÜKLÜ	sif.;
ÇOXSÜMÜKLÜLÜK	is.;
ÇOXSÜRƏTLİ	sif.;
ÇOXSİMALI	sif.;
ÇOXSİMLİ	sif.;
ÇOXSƏNƏTLİ	sif.;
ÇOXSƏPKİLİ	sif.;
ÇOXSƏSLİ	sif.;
ÇOXSƏSLİLİK	is.;
ÇOXSƏVİYYƏLİ	sif.;
ÇOXTAPILAN	f_sif.;
ÇOXTARLALI	sif.;
ÇOXTELLİ	sif.;
ÇOXTERRASLI	sif.;
ÇOXTONLU	sif.;
ÇOXTONLULUQ	is.;
ÇOXTONNAJLI	sif.;
ÇOXTORPAQLI	sif.;
ÇOXTORPAQLILIQ	is.;
ÇOXTOXUMLU	sif.;
ÇOXTOXUMLULUQ	is.;
ÇOXTOXUNAN	sif.;
ÇOXTİLLİ	sif.;
ÇOXTİPLİ	sif.;
ÇOXTİRAJLI	sif.;
ÇOXTİYƏLİ	sif.;
ÇOXTƏBƏQƏLİ	sif.;
ÇOXTƏKƏRLİ	sif.;
ÇOXTƏMAYÜLLÜ	sif.;
ÇOXTƏRƏFLİ	sif.;
ÇOXTƏRƏFLİLİK	is.;
ÇOXU	is.;
ÇOXU-ÇOXU	zer.;
ÇOXUKLADLI	sif.;
ÇOXUKLADLIQ	is.;
ÇOXUSU	is.;
ÇOXUŞAQLI	sif.;
ÇOXUŞAQLILIQ	is.;
ÇOXVALENTLİ	sif.;
ÇOXVAQONLU	sif.;
ÇOXVARİANTLI	sif.;
ÇOXVARİANTLILIQ	is.;
ÇOXVƏZİFƏLİ	sif.;
ÇOXVƏZİYYƏTLİ	sif.;
ÇOXXALQLI	sif.;
ÇOXXƏTLİ	sif.;
ÇOXYANLI	sif.;
ÇOXYARPAQ	is.;
ÇOXYARPAQLI	sif.;
ÇOXYARUSLU	sif.;
ÇOXYAŞAR	sif.;
ÇOXYAŞLI	sif.;
ÇOXYAŞLILIQ	is.;
ÇOXYEMƏ	is.;
ÇOXYERLİ	sif.;
ÇOXYEYƏN	sif.;
ÇOXYUVALI	sif.;
ÇOXYÖNLÜ	sif.;
ÇOXYÜKLÜ	sif.;
ÇOXYÜKLÜLÜK	is.;
ÇOXZOLAQLI	sif.;
ÇOXZONALI	sif.;
ÇOXZÜLALLI	sif.;
ÇOXÇALAN	is.;
ÇOXÇALARLI	sif.;
ÇOXÇALARLILIQ	is.;
ÇOXÇALOVLU	sif.;
ÇOXÇARPAYILI	sif.;
ÇOXÇEŞİDLİ	sif.;
ÇOXÇIXINTILI	sif.;
ÇOXÇİÇƏKLİ	sif.;
ÇOXÇƏLƏKLİ	sif.;
ÇOXÖLÇÜLÜ	sif.;
ÇOXÜLGÜCLÜ	sif.;
ÇOXÜZGƏCLİ	sif.;
ÇOXÜZLÜ	sif.;
ÇOXÜZVLÜ	sif.;
ÇOXİLLİK	sif.;
ÇOXİLMƏLİ	sif.;
ÇOXİRQLİ	sif.;
ÇOXİSTİQAMƏTLİ	sif.;
ÇOXİSTİQAMƏTLİLİK	is.;
ÇOXİYNƏLİ	sif.;
ÇOXİŞLƏK	sif.;
ÇOXİŞLƏKLİK	is.;
ÇOXİŞLƏNMƏ	f.;
ÇOXİŞLƏNƏN	sif.;
ÇOXŞAXƏLİ	sif.;
ÇOXŞPİNDELLİ	sif.;
ÇOXŞÖBƏLİ	sif.;
ÇOXŞÜALI	sif.;
ÇOXŞƏBƏKƏLİ	sif.;
ÇOXŞƏKİLLİ	sif.;
ÇOXŞƏKİLLİLİK	is.;
ÇOXƏHATƏLİ	sif.;
ÇOXƏMƏLİYYATLI	sif.;
ÇOXƏRLİ	sif.;
ÇOXƏRLİLİK	is.;
ÇOXƏSRLİ	sif.;
ÇOXƏSRLİK	is.;
ÇOXƏSRLİLİK	sif.;
