ŞEY	is.;
ŞEY-MEY	is.;
ŞEY-ŞÜY	is.;
ŞEYDA	is.;
ŞEYDALIQ	is.;
ŞEYPUR	is.;
ŞEYPURBURUN	sif.;
ŞEYPURBURUNLU	sif.;
ŞEYPURÇALAN	is.;
ŞEYPURÇU	is.;
ŞEYPURÇULUQ	is.;
ŞEYTAN	is.;
ŞEYTAN-ŞEYTAN	zer.;
ŞEYTAN-ŞUĞUL	is.;
ŞEYTANAĞACI	is.;
ŞEYTANBAZAR	is.;
ŞEYTANCA	sif.;zer.;
ŞEYTANCASINA	zer.;
ŞEYTANDIRNAĞI	is.;
ŞEYTANFİKİR	sif.;
ŞEYTANFİKİRLİ	sif.;
ŞEYTANLA	f.;
ŞEYTANLAN	f.;
ŞEYTANLAT	f.;
ŞEYTANLIQ	is.;
ŞEYTANSİFƏT	sif.;
ŞEYTANSİFƏTLİ	sif.;
ŞEYTANÇILIQ	is.;
ŞEYTANİ	sif.;
ŞEYX	is.;
ŞEYXLİK	is.;
ŞEYXÜLİSLAM	is.;
ŞEYXİ	sif.;
