ŞTABEL	is.;
ŞTABELYOR	is.;
ŞTABS-KAPİTAN	is.;
ŞTABÇI	sif.;
ŞTAMM	is.;
ŞTAMP	is.;
ŞTAMP-QAYNAQ	is.;
ŞTAMPLA	f.;
ŞTAMPLAMA	is.;
ŞTAMPLAMAQ	f.;
ŞTAMPLAN	f.;
ŞTAMPLANMA	is.;
ŞTAMPLANMAQ	f.;
ŞTAMPLAYICI	is.;
ŞTAMPLI	sif.;
ŞTAMPÇI	is.;
ŞTAMPÇILIQ	is.;
ŞTANGENPERGER	is.;
ŞTANGENREYSMUS	is.;
ŞTANQ	is.;
ŞTANQFIRLADAN	sif.;
ŞTANQFIRLADICI	sif.;
ŞTANQQALDIRAN	sif.;
ŞTANQÇI	is.;
ŞTAPEL	is.;
ŞTAT	is.;
ŞTAT	is.;
ŞTATDANKƏNAR	sif.;
ŞTATLI	sif.;
ŞTATİV	is.;
