ƏHL	f.;
ƏHLİ	sif.;
ƏHLİ-BEYT	is.;
ƏHLİ-CAHAN	is.;
ƏHLİ-DÜNYA	is.;
ƏHLİ-DİL	is.;
ƏHLİ-DİVAN	is.;
ƏHLİ-DƏRD	is.;
ƏHLİ-ELM	is.;
ƏHLİ-EŞQ	is.;
ƏHLİ-FƏSAD	is.;
ƏHLİ-HAL	is.;
ƏHLİ-HÜNƏR	is.;
ƏHLİ-HƏSƏD	is.;
ƏHLİ-KAMAL	is.;
ƏHLİ-KEF	is.;
ƏHLİ-KİTAB	is.;
ƏHLİ-KƏRƏM	is.;
ƏHLİ-LİSAN	is.;
ƏHLİ-MƏCLİS	is.;
ƏHLİ-MƏRİFƏT	is.;
ƏHLİ-MƏZAC	is.;
ƏHLİ-NAZ	is.;
ƏHLİ-QÜBUR	is.;
ƏHLİ-QİBLƏ	is.;
ƏHLİ-QƏLƏM	is.;
ƏHLİ-QƏM	is.;
ƏHLİ-QƏRƏZ	is.;
ƏHLİ-RUH	is.;
ƏHLİ-SƏLİB	is.;
ƏHLİ-SƏNƏT	is.;
ƏHLİ-VƏFA	is.;
ƏHLİ-XİBRƏ	is.;
ƏHLİ-XİDMƏT	is.;
ƏHLİ-ZÖVQ	is.;
ƏHLİ-ZÜLM	is.;
ƏHLİ-ZƏLƏMƏ	is.;
ƏHLİ-ÜRFAN	is.;
ƏHLİ-İMAN	is.;
ƏHLİ-İNSAF	is.;
ƏHLİ-ƏYAL	is.;
ƏHLİLƏN	f.;
ƏHLİLƏNMƏ	f.;
ƏHLİLƏNMƏK	f.;
ƏHLİLƏŞ	f.;
ƏHLİLƏŞDİR	f.;
ƏHLİLƏŞDİRMƏ	f.;
ƏHLİLƏŞDİRMƏK	f.;
ƏHLİLƏŞDİRİCİ	sif.;
ƏHLİLƏŞDİRİL	f.;
ƏHLİLƏŞDİRİLMİŞ	f.;
ƏHLİLƏŞDİRİLMƏ	f.;
ƏHLİLƏŞDİRİLMƏK	f.;
ƏHLİLƏŞMİŞ	f.;
ƏHLİLƏŞMƏ	f.;
ƏHLİLƏŞMƏK	f.;
ƏHLİYYƏT	is.;
