ƏNG	is.;
ƏNGALTI	is.;
ƏNGİBOŞ	sif.;
ƏNGİBOŞLUQ	is.;
ƏNGİN	sif.;
ƏNGİNAR	is.;
ƏNGİNLİK	is.;
ƏNGƏBU	is.;
ƏNGƏBİN	is.;
ƏNGƏBƏNGƏ	is.;
ƏNGƏC	is.;
ƏNGƏDUŞ	is.;
ƏNGƏL	is.;
ƏNGƏL-ÜZAR	sif.;
ƏNGƏLLİ	sif.;
ƏNGƏLLƏ	f.;
ƏNGƏLLƏMƏ	f.;
ƏNGƏLLƏMƏK	f.;
ƏNGƏLSİZ	sif.;
ƏNGƏLSİZLİK	is.;
ƏNGƏLÇİ	is.;
ƏNGƏLÜZAR	is.;
ƏNGƏNƏK	is.;
