ƏZA	is.;
ƏZA	is.;
ƏZA	is.;
ƏZA-CƏFA	is.;
ƏZAB	is.;
ƏZAB-İŞGƏNCƏ	is.;
ƏZAB-İŞGƏNCƏLİ	sif.;
ƏZAB-ƏZİYYƏT	is.;
ƏZAB-ƏZİYYƏTLİ	sif.;
ƏZABKEŞ	sif.;
ƏZABLA	f.;
ƏZABLI	sif.;
ƏZABLI-İŞGƏNCƏLİ	sif.;
ƏZABLI-ƏZİYYƏTLİ	sif.;
ƏZABLILIQ	is.;
ƏZABSIZ	sif.;
ƏZABSIZLIQ	is.;
ƏZABVERİCİ	sif.;
ƏZABÇƏKƏN	is.;
ƏZADAR	is.;
ƏZADARLIQ	is.;
ƏZALI	sif.;
ƏZAN	is.;
ƏZAZİL	sif.;
ƏZAZİLCƏSİNƏ	zer.;
ƏZAZİLLİK	is.;
